,team_id,season,formation,coach_id,var_player_1_id,var_player_1_actual_position,var_player_1_overall,var_player_1_potential,var_player_1_value_eur,var_player_1_wage_eur,var_player_1_age,var_player_1_height_cm,var_player_1_weight_kg,var_player_1_league_id,var_player_1_preferred_foot,var_player_1_weak_foot,var_player_1_skill_moves,var_player_1_international_reputation,var_player_1_work_rate,var_player_1_body_type,var_player_1_tag_#Dribbler,var_player_1_tag_#AerialThreat,var_player_1_tag_#Speedster,var_player_1_tag_#DistanceShooter,var_player_1_tag_#Tackling,var_player_1_tag_#Poacher,var_player_1_tag_#Engine,var_player_1_tag_#Crosser,var_player_1_tag_#Playmaker,var_player_1_tag_#ClinicalFinisher,var_player_1_tag_#TacticianÂ ,var_player_1_tag_#TacklingÂ ,var_player_1_tag_#Acrobat,var_player_1_tag_#PlaymakerÂ ,var_player_1_tag_#Tactician,var_player_1_tag_#Strength,var_player_1_tag_#FKSpecialist,var_player_1_tag_#CompleteForward,var_player_1_tag_#CompleteMidfielder,var_player_1_tag_#CompleteDefender,var_player_1_trait_LongShotTaker(AI),var_player_1_trait_FinesseShot,var_player_1_trait_Flair,var_player_1_trait_Leadership,var_player_1_trait_ComesForCrosses,var_player_1_trait_SpeedDribbler(AI),var_player_1_trait_GKLongThrow,var_player_1_trait_LongPasser(AI),var_player_1_trait_DivesIntoTackles(AI),var_player_1_trait_RushesOutOfGoal,var_player_1_trait_OutsideFootShot,var_player_1_trait_PowerHeader,var_player_1_trait_CautiousWithCrosses,var_player_1_trait_ChipShot(AI),var_player_1_trait_TeamPlayer,var_player_1_trait_Playmaker(AI),var_player_1_trait_EarlyCrosser,var_player_1_trait_InjuryProne,var_player_1_trait_TechnicalDribbler(AI),var_player_1_trait_SolidPlayer,var_player_1_trait_SaveswithFeet,var_player_1_trait_GiantThrow-in,var_player_1_trait_PowerFree-Kick,var_player_1_trait_OneClubPlayer,var_player_1_pace,var_player_1_shooting,var_player_1_passing,var_player_1_dribbling,var_player_1_defending,var_player_1_physic,var_player_1_attacking_crossing,var_player_1_attacking_finishing,var_player_1_attacking_heading_accuracy,var_player_1_attacking_short_passing,var_player_1_attacking_volleys,var_player_1_skill_dribbling,var_player_1_skill_curve,var_player_1_skill_fk_accuracy,var_player_1_skill_long_passing,var_player_1_skill_ball_control,var_player_1_movement_acceleration,var_player_1_movement_sprint_speed,var_player_1_movement_agility,var_player_1_movement_reactions,var_player_1_movement_balance,var_player_1_power_shot_power,var_player_1_power_jumping,var_player_1_power_stamina,var_player_1_power_strength,var_player_1_power_long_shots,var_player_1_mentality_aggression,var_player_1_mentality_interceptions,var_player_1_mentality_positioning,var_player_1_mentality_vision,var_player_1_mentality_penalties,var_player_1_mentality_composure,var_player_1_defending_marking_awareness,var_player_1_defending_standing_tackle,var_player_1_defending_sliding_tackle,var_player_1_goalkeeping_diving,var_player_1_goalkeeping_handling,var_player_1_goalkeeping_kicking,var_player_1_goalkeeping_positioning,var_player_1_goalkeeping_reflexes,var_player_1_goalkeeping_speed,var_player_1_ls,var_player_1_st,var_player_1_rs,var_player_1_lw,var_player_1_lf,var_player_1_cf,var_player_1_rf,var_player_1_rw,var_player_1_lam,var_player_1_cam,var_player_1_ram,var_player_1_lm,var_player_1_lcm,var_player_1_cm,var_player_1_rcm,var_player_1_rm,var_player_1_lwb,var_player_1_ldm,var_player_1_cdm,var_player_1_rdm,var_player_1_rwb,var_player_1_lb,var_player_1_lcb,var_player_1_cb,var_player_1_rcb,var_player_1_rb,var_player_1_gk,var_player_1_best_position,var_player_2_id,var_player_2_actual_position,var_player_2_overall,var_player_2_potential,var_player_2_value_eur,var_player_2_wage_eur,var_player_2_age,var_player_2_height_cm,var_player_2_weight_kg,var_player_2_league_id,var_player_2_preferred_foot,var_player_2_weak_foot,var_player_2_skill_moves,var_player_2_international_reputation,var_player_2_work_rate,var_player_2_body_type,var_player_2_tag_#Dribbler,var_player_2_tag_#AerialThreat,var_player_2_tag_#Speedster,var_player_2_tag_#DistanceShooter,var_player_2_tag_#Tackling,var_player_2_tag_#Poacher,var_player_2_tag_#Engine,var_player_2_tag_#Crosser,var_player_2_tag_#Playmaker,var_player_2_tag_#ClinicalFinisher,var_player_2_tag_#TacticianÂ ,var_player_2_tag_#TacklingÂ ,var_player_2_tag_#Acrobat,var_player_2_tag_#PlaymakerÂ ,var_player_2_tag_#Tactician,var_player_2_tag_#Strength,var_player_2_tag_#FKSpecialist,var_player_2_tag_#CompleteForward,var_player_2_tag_#CompleteMidfielder,var_player_2_tag_#CompleteDefender,var_player_2_trait_LongShotTaker(AI),var_player_2_trait_FinesseShot,var_player_2_trait_Flair,var_player_2_trait_Leadership,var_player_2_trait_ComesForCrosses,var_player_2_trait_SpeedDribbler(AI),var_player_2_trait_GKLongThrow,var_player_2_trait_LongPasser(AI),var_player_2_trait_DivesIntoTackles(AI),var_player_2_trait_RushesOutOfGoal,var_player_2_trait_OutsideFootShot,var_player_2_trait_PowerHeader,var_player_2_trait_CautiousWithCrosses,var_player_2_trait_ChipShot(AI),var_player_2_trait_TeamPlayer,var_player_2_trait_Playmaker(AI),var_player_2_trait_EarlyCrosser,var_player_2_trait_InjuryProne,var_player_2_trait_TechnicalDribbler(AI),var_player_2_trait_SolidPlayer,var_player_2_trait_SaveswithFeet,var_player_2_trait_GiantThrow-in,var_player_2_trait_PowerFree-Kick,var_player_2_trait_OneClubPlayer,var_player_2_pace,var_player_2_shooting,var_player_2_passing,var_player_2_dribbling,var_player_2_defending,var_player_2_physic,var_player_2_attacking_crossing,var_player_2_attacking_finishing,var_player_2_attacking_heading_accuracy,var_player_2_attacking_short_passing,var_player_2_attacking_volleys,var_player_2_skill_dribbling,var_player_2_skill_curve,var_player_2_skill_fk_accuracy,var_player_2_skill_long_passing,var_player_2_skill_ball_control,var_player_2_movement_acceleration,var_player_2_movement_sprint_speed,var_player_2_movement_agility,var_player_2_movement_reactions,var_player_2_movement_balance,var_player_2_power_shot_power,var_player_2_power_jumping,var_player_2_power_stamina,var_player_2_power_strength,var_player_2_power_long_shots,var_player_2_mentality_aggression,var_player_2_mentality_interceptions,var_player_2_mentality_positioning,var_player_2_mentality_vision,var_player_2_mentality_penalties,var_player_2_mentality_composure,var_player_2_defending_marking_awareness,var_player_2_defending_standing_tackle,var_player_2_defending_sliding_tackle,var_player_2_goalkeeping_diving,var_player_2_goalkeeping_handling,var_player_2_goalkeeping_kicking,var_player_2_goalkeeping_positioning,var_player_2_goalkeeping_reflexes,var_player_2_goalkeeping_speed,var_player_2_ls,var_player_2_st,var_player_2_rs,var_player_2_lw,var_player_2_lf,var_player_2_cf,var_player_2_rf,var_player_2_rw,var_player_2_lam,var_player_2_cam,var_player_2_ram,var_player_2_lm,var_player_2_lcm,var_player_2_cm,var_player_2_rcm,var_player_2_rm,var_player_2_lwb,var_player_2_ldm,var_player_2_cdm,var_player_2_rdm,var_player_2_rwb,var_player_2_lb,var_player_2_lcb,var_player_2_cb,var_player_2_rcb,var_player_2_rb,var_player_2_gk,var_player_2_best_position,var_player_3_id,var_player_3_actual_position,var_player_3_overall,var_player_3_potential,var_player_3_value_eur,var_player_3_wage_eur,var_player_3_age,var_player_3_height_cm,var_player_3_weight_kg,var_player_3_league_id,var_player_3_preferred_foot,var_player_3_weak_foot,var_player_3_skill_moves,var_player_3_international_reputation,var_player_3_work_rate,var_player_3_body_type,var_player_3_tag_#Dribbler,var_player_3_tag_#AerialThreat,var_player_3_tag_#Speedster,var_player_3_tag_#DistanceShooter,var_player_3_tag_#Tackling,var_player_3_tag_#Poacher,var_player_3_tag_#Engine,var_player_3_tag_#Crosser,var_player_3_tag_#Playmaker,var_player_3_tag_#ClinicalFinisher,var_player_3_tag_#TacticianÂ ,var_player_3_tag_#TacklingÂ ,var_player_3_tag_#Acrobat,var_player_3_tag_#PlaymakerÂ ,var_player_3_tag_#Tactician,var_player_3_tag_#Strength,var_player_3_tag_#FKSpecialist,var_player_3_tag_#CompleteForward,var_player_3_tag_#CompleteMidfielder,var_player_3_tag_#CompleteDefender,var_player_3_trait_LongShotTaker(AI),var_player_3_trait_FinesseShot,var_player_3_trait_Flair,var_player_3_trait_Leadership,var_player_3_trait_ComesForCrosses,var_player_3_trait_SpeedDribbler(AI),var_player_3_trait_GKLongThrow,var_player_3_trait_LongPasser(AI),var_player_3_trait_DivesIntoTackles(AI),var_player_3_trait_RushesOutOfGoal,var_player_3_trait_OutsideFootShot,var_player_3_trait_PowerHeader,var_player_3_trait_CautiousWithCrosses,var_player_3_trait_ChipShot(AI),var_player_3_trait_TeamPlayer,var_player_3_trait_Playmaker(AI),var_player_3_trait_EarlyCrosser,var_player_3_trait_InjuryProne,var_player_3_trait_TechnicalDribbler(AI),var_player_3_trait_SolidPlayer,var_player_3_trait_SaveswithFeet,var_player_3_trait_GiantThrow-in,var_player_3_trait_PowerFree-Kick,var_player_3_trait_OneClubPlayer,var_player_3_pace,var_player_3_shooting,var_player_3_passing,var_player_3_dribbling,var_player_3_defending,var_player_3_physic,var_player_3_attacking_crossing,var_player_3_attacking_finishing,var_player_3_attacking_heading_accuracy,var_player_3_attacking_short_passing,var_player_3_attacking_volleys,var_player_3_skill_dribbling,var_player_3_skill_curve,var_player_3_skill_fk_accuracy,var_player_3_skill_long_passing,var_player_3_skill_ball_control,var_player_3_movement_acceleration,var_player_3_movement_sprint_speed,var_player_3_movement_agility,var_player_3_movement_reactions,var_player_3_movement_balance,var_player_3_power_shot_power,var_player_3_power_jumping,var_player_3_power_stamina,var_player_3_power_strength,var_player_3_power_long_shots,var_player_3_mentality_aggression,var_player_3_mentality_interceptions,var_player_3_mentality_positioning,var_player_3_mentality_vision,var_player_3_mentality_penalties,var_player_3_mentality_composure,var_player_3_defending_marking_awareness,var_player_3_defending_standing_tackle,var_player_3_defending_sliding_tackle,var_player_3_goalkeeping_diving,var_player_3_goalkeeping_handling,var_player_3_goalkeeping_kicking,var_player_3_goalkeeping_positioning,var_player_3_goalkeeping_reflexes,var_player_3_goalkeeping_speed,var_player_3_ls,var_player_3_st,var_player_3_rs,var_player_3_lw,var_player_3_lf,var_player_3_cf,var_player_3_rf,var_player_3_rw,var_player_3_lam,var_player_3_cam,var_player_3_ram,var_player_3_lm,var_player_3_lcm,var_player_3_cm,var_player_3_rcm,var_player_3_rm,var_player_3_lwb,var_player_3_ldm,var_player_3_cdm,var_player_3_rdm,var_player_3_rwb,var_player_3_lb,var_player_3_lcb,var_player_3_cb,var_player_3_rcb,var_player_3_rb,var_player_3_gk,var_player_3_best_position,var_player_4_id,var_player_4_actual_position,var_player_4_overall,var_player_4_potential,var_player_4_value_eur,var_player_4_wage_eur,var_player_4_age,var_player_4_height_cm,var_player_4_weight_kg,var_player_4_league_id,var_player_4_preferred_foot,var_player_4_weak_foot,var_player_4_skill_moves,var_player_4_international_reputation,var_player_4_work_rate,var_player_4_body_type,var_player_4_tag_#Dribbler,var_player_4_tag_#AerialThreat,var_player_4_tag_#Speedster,var_player_4_tag_#DistanceShooter,var_player_4_tag_#Tackling,var_player_4_tag_#Poacher,var_player_4_tag_#Engine,var_player_4_tag_#Crosser,var_player_4_tag_#Playmaker,var_player_4_tag_#ClinicalFinisher,var_player_4_tag_#TacticianÂ ,var_player_4_tag_#TacklingÂ ,var_player_4_tag_#Acrobat,var_player_4_tag_#PlaymakerÂ ,var_player_4_tag_#Tactician,var_player_4_tag_#Strength,var_player_4_tag_#FKSpecialist,var_player_4_tag_#CompleteForward,var_player_4_tag_#CompleteMidfielder,var_player_4_tag_#CompleteDefender,var_player_4_trait_LongShotTaker(AI),var_player_4_trait_FinesseShot,var_player_4_trait_Flair,var_player_4_trait_Leadership,var_player_4_trait_ComesForCrosses,var_player_4_trait_SpeedDribbler(AI),var_player_4_trait_GKLongThrow,var_player_4_trait_LongPasser(AI),var_player_4_trait_DivesIntoTackles(AI),var_player_4_trait_RushesOutOfGoal,var_player_4_trait_OutsideFootShot,var_player_4_trait_PowerHeader,var_player_4_trait_CautiousWithCrosses,var_player_4_trait_ChipShot(AI),var_player_4_trait_TeamPlayer,var_player_4_trait_Playmaker(AI),var_player_4_trait_EarlyCrosser,var_player_4_trait_InjuryProne,var_player_4_trait_TechnicalDribbler(AI),var_player_4_trait_SolidPlayer,var_player_4_trait_SaveswithFeet,var_player_4_trait_GiantThrow-in,var_player_4_trait_PowerFree-Kick,var_player_4_trait_OneClubPlayer,var_player_4_pace,var_player_4_shooting,var_player_4_passing,var_player_4_dribbling,var_player_4_defending,var_player_4_physic,var_player_4_attacking_crossing,var_player_4_attacking_finishing,var_player_4_attacking_heading_accuracy,var_player_4_attacking_short_passing,var_player_4_attacking_volleys,var_player_4_skill_dribbling,var_player_4_skill_curve,var_player_4_skill_fk_accuracy,var_player_4_skill_long_passing,var_player_4_skill_ball_control,var_player_4_movement_acceleration,var_player_4_movement_sprint_speed,var_player_4_movement_agility,var_player_4_movement_reactions,var_player_4_movement_balance,var_player_4_power_shot_power,var_player_4_power_jumping,var_player_4_power_stamina,var_player_4_power_strength,var_player_4_power_long_shots,var_player_4_mentality_aggression,var_player_4_mentality_interceptions,var_player_4_mentality_positioning,var_player_4_mentality_vision,var_player_4_mentality_penalties,var_player_4_mentality_composure,var_player_4_defending_marking_awareness,var_player_4_defending_standing_tackle,var_player_4_defending_sliding_tackle,var_player_4_goalkeeping_diving,var_player_4_goalkeeping_handling,var_player_4_goalkeeping_kicking,var_player_4_goalkeeping_positioning,var_player_4_goalkeeping_reflexes,var_player_4_goalkeeping_speed,var_player_4_ls,var_player_4_st,var_player_4_rs,var_player_4_lw,var_player_4_lf,var_player_4_cf,var_player_4_rf,var_player_4_rw,var_player_4_lam,var_player_4_cam,var_player_4_ram,var_player_4_lm,var_player_4_lcm,var_player_4_cm,var_player_4_rcm,var_player_4_rm,var_player_4_lwb,var_player_4_ldm,var_player_4_cdm,var_player_4_rdm,var_player_4_rwb,var_player_4_lb,var_player_4_lcb,var_player_4_cb,var_player_4_rcb,var_player_4_rb,var_player_4_gk,var_player_4_best_position,var_player_5_id,var_player_5_actual_position,var_player_5_overall,var_player_5_potential,var_player_5_value_eur,var_player_5_wage_eur,var_player_5_age,var_player_5_height_cm,var_player_5_weight_kg,var_player_5_league_id,var_player_5_preferred_foot,var_player_5_weak_foot,var_player_5_skill_moves,var_player_5_international_reputation,var_player_5_work_rate,var_player_5_body_type,var_player_5_tag_#Dribbler,var_player_5_tag_#AerialThreat,var_player_5_tag_#Speedster,var_player_5_tag_#DistanceShooter,var_player_5_tag_#Tackling,var_player_5_tag_#Poacher,var_player_5_tag_#Engine,var_player_5_tag_#Crosser,var_player_5_tag_#Playmaker,var_player_5_tag_#ClinicalFinisher,var_player_5_tag_#TacticianÂ ,var_player_5_tag_#TacklingÂ ,var_player_5_tag_#Acrobat,var_player_5_tag_#PlaymakerÂ ,var_player_5_tag_#Tactician,var_player_5_tag_#Strength,var_player_5_tag_#FKSpecialist,var_player_5_tag_#CompleteForward,var_player_5_tag_#CompleteMidfielder,var_player_5_tag_#CompleteDefender,var_player_5_trait_LongShotTaker(AI),var_player_5_trait_FinesseShot,var_player_5_trait_Flair,var_player_5_trait_Leadership,var_player_5_trait_ComesForCrosses,var_player_5_trait_SpeedDribbler(AI),var_player_5_trait_GKLongThrow,var_player_5_trait_LongPasser(AI),var_player_5_trait_DivesIntoTackles(AI),var_player_5_trait_RushesOutOfGoal,var_player_5_trait_OutsideFootShot,var_player_5_trait_PowerHeader,var_player_5_trait_CautiousWithCrosses,var_player_5_trait_ChipShot(AI),var_player_5_trait_TeamPlayer,var_player_5_trait_Playmaker(AI),var_player_5_trait_EarlyCrosser,var_player_5_trait_InjuryProne,var_player_5_trait_TechnicalDribbler(AI),var_player_5_trait_SolidPlayer,var_player_5_trait_SaveswithFeet,var_player_5_trait_GiantThrow-in,var_player_5_trait_PowerFree-Kick,var_player_5_trait_OneClubPlayer,var_player_5_pace,var_player_5_shooting,var_player_5_passing,var_player_5_dribbling,var_player_5_defending,var_player_5_physic,var_player_5_attacking_crossing,var_player_5_attacking_finishing,var_player_5_attacking_heading_accuracy,var_player_5_attacking_short_passing,var_player_5_attacking_volleys,var_player_5_skill_dribbling,var_player_5_skill_curve,var_player_5_skill_fk_accuracy,var_player_5_skill_long_passing,var_player_5_skill_ball_control,var_player_5_movement_acceleration,var_player_5_movement_sprint_speed,var_player_5_movement_agility,var_player_5_movement_reactions,var_player_5_movement_balance,var_player_5_power_shot_power,var_player_5_power_jumping,var_player_5_power_stamina,var_player_5_power_strength,var_player_5_power_long_shots,var_player_5_mentality_aggression,var_player_5_mentality_interceptions,var_player_5_mentality_positioning,var_player_5_mentality_vision,var_player_5_mentality_penalties,var_player_5_mentality_composure,var_player_5_defending_marking_awareness,var_player_5_defending_standing_tackle,var_player_5_defending_sliding_tackle,var_player_5_goalkeeping_diving,var_player_5_goalkeeping_handling,var_player_5_goalkeeping_kicking,var_player_5_goalkeeping_positioning,var_player_5_goalkeeping_reflexes,var_player_5_goalkeeping_speed,var_player_5_ls,var_player_5_st,var_player_5_rs,var_player_5_lw,var_player_5_lf,var_player_5_cf,var_player_5_rf,var_player_5_rw,var_player_5_lam,var_player_5_cam,var_player_5_ram,var_player_5_lm,var_player_5_lcm,var_player_5_cm,var_player_5_rcm,var_player_5_rm,var_player_5_lwb,var_player_5_ldm,var_player_5_cdm,var_player_5_rdm,var_player_5_rwb,var_player_5_lb,var_player_5_lcb,var_player_5_cb,var_player_5_rcb,var_player_5_rb,var_player_5_gk,var_player_5_best_position,var_player_6_id,var_player_6_actual_position,var_player_6_overall,var_player_6_potential,var_player_6_value_eur,var_player_6_wage_eur,var_player_6_age,var_player_6_height_cm,var_player_6_weight_kg,var_player_6_league_id,var_player_6_preferred_foot,var_player_6_weak_foot,var_player_6_skill_moves,var_player_6_international_reputation,var_player_6_work_rate,var_player_6_body_type,var_player_6_tag_#Dribbler,var_player_6_tag_#AerialThreat,var_player_6_tag_#Speedster,var_player_6_tag_#DistanceShooter,var_player_6_tag_#Tackling,var_player_6_tag_#Poacher,var_player_6_tag_#Engine,var_player_6_tag_#Crosser,var_player_6_tag_#Playmaker,var_player_6_tag_#ClinicalFinisher,var_player_6_tag_#TacticianÂ ,var_player_6_tag_#TacklingÂ ,var_player_6_tag_#Acrobat,var_player_6_tag_#PlaymakerÂ ,var_player_6_tag_#Tactician,var_player_6_tag_#Strength,var_player_6_tag_#FKSpecialist,var_player_6_tag_#CompleteForward,var_player_6_tag_#CompleteMidfielder,var_player_6_tag_#CompleteDefender,var_player_6_trait_LongShotTaker(AI),var_player_6_trait_FinesseShot,var_player_6_trait_Flair,var_player_6_trait_Leadership,var_player_6_trait_ComesForCrosses,var_player_6_trait_SpeedDribbler(AI),var_player_6_trait_GKLongThrow,var_player_6_trait_LongPasser(AI),var_player_6_trait_DivesIntoTackles(AI),var_player_6_trait_RushesOutOfGoal,var_player_6_trait_OutsideFootShot,var_player_6_trait_PowerHeader,var_player_6_trait_CautiousWithCrosses,var_player_6_trait_ChipShot(AI),var_player_6_trait_TeamPlayer,var_player_6_trait_Playmaker(AI),var_player_6_trait_EarlyCrosser,var_player_6_trait_InjuryProne,var_player_6_trait_TechnicalDribbler(AI),var_player_6_trait_SolidPlayer,var_player_6_trait_SaveswithFeet,var_player_6_trait_GiantThrow-in,var_player_6_trait_PowerFree-Kick,var_player_6_trait_OneClubPlayer,var_player_6_pace,var_player_6_shooting,var_player_6_passing,var_player_6_dribbling,var_player_6_defending,var_player_6_physic,var_player_6_attacking_crossing,var_player_6_attacking_finishing,var_player_6_attacking_heading_accuracy,var_player_6_attacking_short_passing,var_player_6_attacking_volleys,var_player_6_skill_dribbling,var_player_6_skill_curve,var_player_6_skill_fk_accuracy,var_player_6_skill_long_passing,var_player_6_skill_ball_control,var_player_6_movement_acceleration,var_player_6_movement_sprint_speed,var_player_6_movement_agility,var_player_6_movement_reactions,var_player_6_movement_balance,var_player_6_power_shot_power,var_player_6_power_jumping,var_player_6_power_stamina,var_player_6_power_strength,var_player_6_power_long_shots,var_player_6_mentality_aggression,var_player_6_mentality_interceptions,var_player_6_mentality_positioning,var_player_6_mentality_vision,var_player_6_mentality_penalties,var_player_6_mentality_composure,var_player_6_defending_marking_awareness,var_player_6_defending_standing_tackle,var_player_6_defending_sliding_tackle,var_player_6_goalkeeping_diving,var_player_6_goalkeeping_handling,var_player_6_goalkeeping_kicking,var_player_6_goalkeeping_positioning,var_player_6_goalkeeping_reflexes,var_player_6_goalkeeping_speed,var_player_6_ls,var_player_6_st,var_player_6_rs,var_player_6_lw,var_player_6_lf,var_player_6_cf,var_player_6_rf,var_player_6_rw,var_player_6_lam,var_player_6_cam,var_player_6_ram,var_player_6_lm,var_player_6_lcm,var_player_6_cm,var_player_6_rcm,var_player_6_rm,var_player_6_lwb,var_player_6_ldm,var_player_6_cdm,var_player_6_rdm,var_player_6_rwb,var_player_6_lb,var_player_6_lcb,var_player_6_cb,var_player_6_rcb,var_player_6_rb,var_player_6_gk,var_player_6_best_position,var_player_7_id,var_player_7_actual_position,var_player_7_overall,var_player_7_potential,var_player_7_value_eur,var_player_7_wage_eur,var_player_7_age,var_player_7_height_cm,var_player_7_weight_kg,var_player_7_league_id,var_player_7_preferred_foot,var_player_7_weak_foot,var_player_7_skill_moves,var_player_7_international_reputation,var_player_7_work_rate,var_player_7_body_type,var_player_7_tag_#Dribbler,var_player_7_tag_#AerialThreat,var_player_7_tag_#Speedster,var_player_7_tag_#DistanceShooter,var_player_7_tag_#Tackling,var_player_7_tag_#Poacher,var_player_7_tag_#Engine,var_player_7_tag_#Crosser,var_player_7_tag_#Playmaker,var_player_7_tag_#ClinicalFinisher,var_player_7_tag_#TacticianÂ ,var_player_7_tag_#TacklingÂ ,var_player_7_tag_#Acrobat,var_player_7_tag_#PlaymakerÂ ,var_player_7_tag_#Tactician,var_player_7_tag_#Strength,var_player_7_tag_#FKSpecialist,var_player_7_tag_#CompleteForward,var_player_7_tag_#CompleteMidfielder,var_player_7_tag_#CompleteDefender,var_player_7_trait_LongShotTaker(AI),var_player_7_trait_FinesseShot,var_player_7_trait_Flair,var_player_7_trait_Leadership,var_player_7_trait_ComesForCrosses,var_player_7_trait_SpeedDribbler(AI),var_player_7_trait_GKLongThrow,var_player_7_trait_LongPasser(AI),var_player_7_trait_DivesIntoTackles(AI),var_player_7_trait_RushesOutOfGoal,var_player_7_trait_OutsideFootShot,var_player_7_trait_PowerHeader,var_player_7_trait_CautiousWithCrosses,var_player_7_trait_ChipShot(AI),var_player_7_trait_TeamPlayer,var_player_7_trait_Playmaker(AI),var_player_7_trait_EarlyCrosser,var_player_7_trait_InjuryProne,var_player_7_trait_TechnicalDribbler(AI),var_player_7_trait_SolidPlayer,var_player_7_trait_SaveswithFeet,var_player_7_trait_GiantThrow-in,var_player_7_trait_PowerFree-Kick,var_player_7_trait_OneClubPlayer,var_player_7_pace,var_player_7_shooting,var_player_7_passing,var_player_7_dribbling,var_player_7_defending,var_player_7_physic,var_player_7_attacking_crossing,var_player_7_attacking_finishing,var_player_7_attacking_heading_accuracy,var_player_7_attacking_short_passing,var_player_7_attacking_volleys,var_player_7_skill_dribbling,var_player_7_skill_curve,var_player_7_skill_fk_accuracy,var_player_7_skill_long_passing,var_player_7_skill_ball_control,var_player_7_movement_acceleration,var_player_7_movement_sprint_speed,var_player_7_movement_agility,var_player_7_movement_reactions,var_player_7_movement_balance,var_player_7_power_shot_power,var_player_7_power_jumping,var_player_7_power_stamina,var_player_7_power_strength,var_player_7_power_long_shots,var_player_7_mentality_aggression,var_player_7_mentality_interceptions,var_player_7_mentality_positioning,var_player_7_mentality_vision,var_player_7_mentality_penalties,var_player_7_mentality_composure,var_player_7_defending_marking_awareness,var_player_7_defending_standing_tackle,var_player_7_defending_sliding_tackle,var_player_7_goalkeeping_diving,var_player_7_goalkeeping_handling,var_player_7_goalkeeping_kicking,var_player_7_goalkeeping_positioning,var_player_7_goalkeeping_reflexes,var_player_7_goalkeeping_speed,var_player_7_ls,var_player_7_st,var_player_7_rs,var_player_7_lw,var_player_7_lf,var_player_7_cf,var_player_7_rf,var_player_7_rw,var_player_7_lam,var_player_7_cam,var_player_7_ram,var_player_7_lm,var_player_7_lcm,var_player_7_cm,var_player_7_rcm,var_player_7_rm,var_player_7_lwb,var_player_7_ldm,var_player_7_cdm,var_player_7_rdm,var_player_7_rwb,var_player_7_lb,var_player_7_lcb,var_player_7_cb,var_player_7_rcb,var_player_7_rb,var_player_7_gk,var_player_7_best_position,var_player_8_id,var_player_8_actual_position,var_player_8_overall,var_player_8_potential,var_player_8_value_eur,var_player_8_wage_eur,var_player_8_age,var_player_8_height_cm,var_player_8_weight_kg,var_player_8_league_id,var_player_8_preferred_foot,var_player_8_weak_foot,var_player_8_skill_moves,var_player_8_international_reputation,var_player_8_work_rate,var_player_8_body_type,var_player_8_tag_#Dribbler,var_player_8_tag_#AerialThreat,var_player_8_tag_#Speedster,var_player_8_tag_#DistanceShooter,var_player_8_tag_#Tackling,var_player_8_tag_#Poacher,var_player_8_tag_#Engine,var_player_8_tag_#Crosser,var_player_8_tag_#Playmaker,var_player_8_tag_#ClinicalFinisher,var_player_8_tag_#TacticianÂ ,var_player_8_tag_#TacklingÂ ,var_player_8_tag_#Acrobat,var_player_8_tag_#PlaymakerÂ ,var_player_8_tag_#Tactician,var_player_8_tag_#Strength,var_player_8_tag_#FKSpecialist,var_player_8_tag_#CompleteForward,var_player_8_tag_#CompleteMidfielder,var_player_8_tag_#CompleteDefender,var_player_8_trait_LongShotTaker(AI),var_player_8_trait_FinesseShot,var_player_8_trait_Flair,var_player_8_trait_Leadership,var_player_8_trait_ComesForCrosses,var_player_8_trait_SpeedDribbler(AI),var_player_8_trait_GKLongThrow,var_player_8_trait_LongPasser(AI),var_player_8_trait_DivesIntoTackles(AI),var_player_8_trait_RushesOutOfGoal,var_player_8_trait_OutsideFootShot,var_player_8_trait_PowerHeader,var_player_8_trait_CautiousWithCrosses,var_player_8_trait_ChipShot(AI),var_player_8_trait_TeamPlayer,var_player_8_trait_Playmaker(AI),var_player_8_trait_EarlyCrosser,var_player_8_trait_InjuryProne,var_player_8_trait_TechnicalDribbler(AI),var_player_8_trait_SolidPlayer,var_player_8_trait_SaveswithFeet,var_player_8_trait_GiantThrow-in,var_player_8_trait_PowerFree-Kick,var_player_8_trait_OneClubPlayer,var_player_8_pace,var_player_8_shooting,var_player_8_passing,var_player_8_dribbling,var_player_8_defending,var_player_8_physic,var_player_8_attacking_crossing,var_player_8_attacking_finishing,var_player_8_attacking_heading_accuracy,var_player_8_attacking_short_passing,var_player_8_attacking_volleys,var_player_8_skill_dribbling,var_player_8_skill_curve,var_player_8_skill_fk_accuracy,var_player_8_skill_long_passing,var_player_8_skill_ball_control,var_player_8_movement_acceleration,var_player_8_movement_sprint_speed,var_player_8_movement_agility,var_player_8_movement_reactions,var_player_8_movement_balance,var_player_8_power_shot_power,var_player_8_power_jumping,var_player_8_power_stamina,var_player_8_power_strength,var_player_8_power_long_shots,var_player_8_mentality_aggression,var_player_8_mentality_interceptions,var_player_8_mentality_positioning,var_player_8_mentality_vision,var_player_8_mentality_penalties,var_player_8_mentality_composure,var_player_8_defending_marking_awareness,var_player_8_defending_standing_tackle,var_player_8_defending_sliding_tackle,var_player_8_goalkeeping_diving,var_player_8_goalkeeping_handling,var_player_8_goalkeeping_kicking,var_player_8_goalkeeping_positioning,var_player_8_goalkeeping_reflexes,var_player_8_goalkeeping_speed,var_player_8_ls,var_player_8_st,var_player_8_rs,var_player_8_lw,var_player_8_lf,var_player_8_cf,var_player_8_rf,var_player_8_rw,var_player_8_lam,var_player_8_cam,var_player_8_ram,var_player_8_lm,var_player_8_lcm,var_player_8_cm,var_player_8_rcm,var_player_8_rm,var_player_8_lwb,var_player_8_ldm,var_player_8_cdm,var_player_8_rdm,var_player_8_rwb,var_player_8_lb,var_player_8_lcb,var_player_8_cb,var_player_8_rcb,var_player_8_rb,var_player_8_gk,var_player_8_best_position,var_player_9_id,var_player_9_actual_position,var_player_9_overall,var_player_9_potential,var_player_9_value_eur,var_player_9_wage_eur,var_player_9_age,var_player_9_height_cm,var_player_9_weight_kg,var_player_9_league_id,var_player_9_preferred_foot,var_player_9_weak_foot,var_player_9_skill_moves,var_player_9_international_reputation,var_player_9_work_rate,var_player_9_body_type,var_player_9_tag_#Dribbler,var_player_9_tag_#AerialThreat,var_player_9_tag_#Speedster,var_player_9_tag_#DistanceShooter,var_player_9_tag_#Tackling,var_player_9_tag_#Poacher,var_player_9_tag_#Engine,var_player_9_tag_#Crosser,var_player_9_tag_#Playmaker,var_player_9_tag_#ClinicalFinisher,var_player_9_tag_#TacticianÂ ,var_player_9_tag_#TacklingÂ ,var_player_9_tag_#Acrobat,var_player_9_tag_#PlaymakerÂ ,var_player_9_tag_#Tactician,var_player_9_tag_#Strength,var_player_9_tag_#FKSpecialist,var_player_9_tag_#CompleteForward,var_player_9_tag_#CompleteMidfielder,var_player_9_tag_#CompleteDefender,var_player_9_trait_LongShotTaker(AI),var_player_9_trait_FinesseShot,var_player_9_trait_Flair,var_player_9_trait_Leadership,var_player_9_trait_ComesForCrosses,var_player_9_trait_SpeedDribbler(AI),var_player_9_trait_GKLongThrow,var_player_9_trait_LongPasser(AI),var_player_9_trait_DivesIntoTackles(AI),var_player_9_trait_RushesOutOfGoal,var_player_9_trait_OutsideFootShot,var_player_9_trait_PowerHeader,var_player_9_trait_CautiousWithCrosses,var_player_9_trait_ChipShot(AI),var_player_9_trait_TeamPlayer,var_player_9_trait_Playmaker(AI),var_player_9_trait_EarlyCrosser,var_player_9_trait_InjuryProne,var_player_9_trait_TechnicalDribbler(AI),var_player_9_trait_SolidPlayer,var_player_9_trait_SaveswithFeet,var_player_9_trait_GiantThrow-in,var_player_9_trait_PowerFree-Kick,var_player_9_trait_OneClubPlayer,var_player_9_pace,var_player_9_shooting,var_player_9_passing,var_player_9_dribbling,var_player_9_defending,var_player_9_physic,var_player_9_attacking_crossing,var_player_9_attacking_finishing,var_player_9_attacking_heading_accuracy,var_player_9_attacking_short_passing,var_player_9_attacking_volleys,var_player_9_skill_dribbling,var_player_9_skill_curve,var_player_9_skill_fk_accuracy,var_player_9_skill_long_passing,var_player_9_skill_ball_control,var_player_9_movement_acceleration,var_player_9_movement_sprint_speed,var_player_9_movement_agility,var_player_9_movement_reactions,var_player_9_movement_balance,var_player_9_power_shot_power,var_player_9_power_jumping,var_player_9_power_stamina,var_player_9_power_strength,var_player_9_power_long_shots,var_player_9_mentality_aggression,var_player_9_mentality_interceptions,var_player_9_mentality_positioning,var_player_9_mentality_vision,var_player_9_mentality_penalties,var_player_9_mentality_composure,var_player_9_defending_marking_awareness,var_player_9_defending_standing_tackle,var_player_9_defending_sliding_tackle,var_player_9_goalkeeping_diving,var_player_9_goalkeeping_handling,var_player_9_goalkeeping_kicking,var_player_9_goalkeeping_positioning,var_player_9_goalkeeping_reflexes,var_player_9_goalkeeping_speed,var_player_9_ls,var_player_9_st,var_player_9_rs,var_player_9_lw,var_player_9_lf,var_player_9_cf,var_player_9_rf,var_player_9_rw,var_player_9_lam,var_player_9_cam,var_player_9_ram,var_player_9_lm,var_player_9_lcm,var_player_9_cm,var_player_9_rcm,var_player_9_rm,var_player_9_lwb,var_player_9_ldm,var_player_9_cdm,var_player_9_rdm,var_player_9_rwb,var_player_9_lb,var_player_9_lcb,var_player_9_cb,var_player_9_rcb,var_player_9_rb,var_player_9_gk,var_player_9_best_position,var_player_10_id,var_player_10_actual_position,var_player_10_overall,var_player_10_potential,var_player_10_value_eur,var_player_10_wage_eur,var_player_10_age,var_player_10_height_cm,var_player_10_weight_kg,var_player_10_league_id,var_player_10_preferred_foot,var_player_10_weak_foot,var_player_10_skill_moves,var_player_10_international_reputation,var_player_10_work_rate,var_player_10_body_type,var_player_10_tag_#Dribbler,var_player_10_tag_#AerialThreat,var_player_10_tag_#Speedster,var_player_10_tag_#DistanceShooter,var_player_10_tag_#Tackling,var_player_10_tag_#Poacher,var_player_10_tag_#Engine,var_player_10_tag_#Crosser,var_player_10_tag_#Playmaker,var_player_10_tag_#ClinicalFinisher,var_player_10_tag_#TacticianÂ ,var_player_10_tag_#TacklingÂ ,var_player_10_tag_#Acrobat,var_player_10_tag_#PlaymakerÂ ,var_player_10_tag_#Tactician,var_player_10_tag_#Strength,var_player_10_tag_#FKSpecialist,var_player_10_tag_#CompleteForward,var_player_10_tag_#CompleteMidfielder,var_player_10_tag_#CompleteDefender,var_player_10_trait_LongShotTaker(AI),var_player_10_trait_FinesseShot,var_player_10_trait_Flair,var_player_10_trait_Leadership,var_player_10_trait_ComesForCrosses,var_player_10_trait_SpeedDribbler(AI),var_player_10_trait_GKLongThrow,var_player_10_trait_LongPasser(AI),var_player_10_trait_DivesIntoTackles(AI),var_player_10_trait_RushesOutOfGoal,var_player_10_trait_OutsideFootShot,var_player_10_trait_PowerHeader,var_player_10_trait_CautiousWithCrosses,var_player_10_trait_ChipShot(AI),var_player_10_trait_TeamPlayer,var_player_10_trait_Playmaker(AI),var_player_10_trait_EarlyCrosser,var_player_10_trait_InjuryProne,var_player_10_trait_TechnicalDribbler(AI),var_player_10_trait_SolidPlayer,var_player_10_trait_SaveswithFeet,var_player_10_trait_GiantThrow-in,var_player_10_trait_PowerFree-Kick,var_player_10_trait_OneClubPlayer,var_player_10_pace,var_player_10_shooting,var_player_10_passing,var_player_10_dribbling,var_player_10_defending,var_player_10_physic,var_player_10_attacking_crossing,var_player_10_attacking_finishing,var_player_10_attacking_heading_accuracy,var_player_10_attacking_short_passing,var_player_10_attacking_volleys,var_player_10_skill_dribbling,var_player_10_skill_curve,var_player_10_skill_fk_accuracy,var_player_10_skill_long_passing,var_player_10_skill_ball_control,var_player_10_movement_acceleration,var_player_10_movement_sprint_speed,var_player_10_movement_agility,var_player_10_movement_reactions,var_player_10_movement_balance,var_player_10_power_shot_power,var_player_10_power_jumping,var_player_10_power_stamina,var_player_10_power_strength,var_player_10_power_long_shots,var_player_10_mentality_aggression,var_player_10_mentality_interceptions,var_player_10_mentality_positioning,var_player_10_mentality_vision,var_player_10_mentality_penalties,var_player_10_mentality_composure,var_player_10_defending_marking_awareness,var_player_10_defending_standing_tackle,var_player_10_defending_sliding_tackle,var_player_10_goalkeeping_diving,var_player_10_goalkeeping_handling,var_player_10_goalkeeping_kicking,var_player_10_goalkeeping_positioning,var_player_10_goalkeeping_reflexes,var_player_10_goalkeeping_speed,var_player_10_ls,var_player_10_st,var_player_10_rs,var_player_10_lw,var_player_10_lf,var_player_10_cf,var_player_10_rf,var_player_10_rw,var_player_10_lam,var_player_10_cam,var_player_10_ram,var_player_10_lm,var_player_10_lcm,var_player_10_cm,var_player_10_rcm,var_player_10_rm,var_player_10_lwb,var_player_10_ldm,var_player_10_cdm,var_player_10_rdm,var_player_10_rwb,var_player_10_lb,var_player_10_lcb,var_player_10_cb,var_player_10_rcb,var_player_10_rb,var_player_10_gk,var_player_10_best_position,var_player_11_id,var_player_11_actual_position,var_player_11_overall,var_player_11_potential,var_player_11_value_eur,var_player_11_wage_eur,var_player_11_age,var_player_11_height_cm,var_player_11_weight_kg,var_player_11_league_id,var_player_11_preferred_foot,var_player_11_weak_foot,var_player_11_skill_moves,var_player_11_international_reputation,var_player_11_work_rate,var_player_11_body_type,var_player_11_tag_#Dribbler,var_player_11_tag_#AerialThreat,var_player_11_tag_#Speedster,var_player_11_tag_#DistanceShooter,var_player_11_tag_#Tackling,var_player_11_tag_#Poacher,var_player_11_tag_#Engine,var_player_11_tag_#Crosser,var_player_11_tag_#Playmaker,var_player_11_tag_#ClinicalFinisher,var_player_11_tag_#TacticianÂ ,var_player_11_tag_#TacklingÂ ,var_player_11_tag_#Acrobat,var_player_11_tag_#PlaymakerÂ ,var_player_11_tag_#Tactician,var_player_11_tag_#Strength,var_player_11_tag_#FKSpecialist,var_player_11_tag_#CompleteForward,var_player_11_tag_#CompleteMidfielder,var_player_11_tag_#CompleteDefender,var_player_11_trait_LongShotTaker(AI),var_player_11_trait_FinesseShot,var_player_11_trait_Flair,var_player_11_trait_Leadership,var_player_11_trait_ComesForCrosses,var_player_11_trait_SpeedDribbler(AI),var_player_11_trait_GKLongThrow,var_player_11_trait_LongPasser(AI),var_player_11_trait_DivesIntoTackles(AI),var_player_11_trait_RushesOutOfGoal,var_player_11_trait_OutsideFootShot,var_player_11_trait_PowerHeader,var_player_11_trait_CautiousWithCrosses,var_player_11_trait_ChipShot(AI),var_player_11_trait_TeamPlayer,var_player_11_trait_Playmaker(AI),var_player_11_trait_EarlyCrosser,var_player_11_trait_InjuryProne,var_player_11_trait_TechnicalDribbler(AI),var_player_11_trait_SolidPlayer,var_player_11_trait_SaveswithFeet,var_player_11_trait_GiantThrow-in,var_player_11_trait_PowerFree-Kick,var_player_11_trait_OneClubPlayer,var_player_11_pace,var_player_11_shooting,var_player_11_passing,var_player_11_dribbling,var_player_11_defending,var_player_11_physic,var_player_11_attacking_crossing,var_player_11_attacking_finishing,var_player_11_attacking_heading_accuracy,var_player_11_attacking_short_passing,var_player_11_attacking_volleys,var_player_11_skill_dribbling,var_player_11_skill_curve,var_player_11_skill_fk_accuracy,var_player_11_skill_long_passing,var_player_11_skill_ball_control,var_player_11_movement_acceleration,var_player_11_movement_sprint_speed,var_player_11_movement_agility,var_player_11_movement_reactions,var_player_11_movement_balance,var_player_11_power_shot_power,var_player_11_power_jumping,var_player_11_power_stamina,var_player_11_power_strength,var_player_11_power_long_shots,var_player_11_mentality_aggression,var_player_11_mentality_interceptions,var_player_11_mentality_positioning,var_player_11_mentality_vision,var_player_11_mentality_penalties,var_player_11_mentality_composure,var_player_11_defending_marking_awareness,var_player_11_defending_standing_tackle,var_player_11_defending_sliding_tackle,var_player_11_goalkeeping_diving,var_player_11_goalkeeping_handling,var_player_11_goalkeeping_kicking,var_player_11_goalkeeping_positioning,var_player_11_goalkeeping_reflexes,var_player_11_goalkeeping_speed,var_player_11_ls,var_player_11_st,var_player_11_rs,var_player_11_lw,var_player_11_lf,var_player_11_cf,var_player_11_rf,var_player_11_rw,var_player_11_lam,var_player_11_cam,var_player_11_ram,var_player_11_lm,var_player_11_lcm,var_player_11_cm,var_player_11_rcm,var_player_11_rm,var_player_11_lwb,var_player_11_ldm,var_player_11_cdm,var_player_11_rdm,var_player_11_rwb,var_player_11_lb,var_player_11_lcb,var_player_11_cb,var_player_11_rcb,var_player_11_rb,var_player_11_gk,var_player_11_best_position
0,10.0,2022.0,4-3-2-1,to_be_implemented,210257,GK,89,91,88000000.0,210000.0,28,188,86,13.0,Left,3,1,3,Medium/Medium,Unique,False,False,False,False,False,False,False,False,False,False,False,False,False,False,False,False,False,False,False,False,False,False,False,False,False,False,False,False,False,False,False,False,False,False,False,False,False,False,False,False,False,False,False,False,,,,,,,20,14,14,61,18,23,15,20,66,40,64,63,60,88,48,70,66,41,78,18,38,27,20,70,51,70.0,29,15,8,87,82,93,88,88,64.0,40+3,40+3,40+3,41,43,43,43,41,47+3,47+3,47+3,44+3,49+3,49+3,49+3,44+3,37+3,44+3,44+3,44+3,37+3,36+3,35+3,35+3,35+3,36+3,87+3,GK,188377,RB|RWB,85,85,37500000.0,170000.0,32,183,83,13.0,Right,2,3,3,High/High,Unique,False,False,False,False,False,False,False,False,False,False,False,False,False,False,False,False,False,False,False,False,False,False,False,False,False,False,False,False,False,False,False,False,False,False,False,False,False,False,False,False,False,False,False,False,91.0,63.0,77.0,78.0,80.0,82.0,77,51,74,80,57,79,76,71,81,81,87,94,66,85,69,86,83,86,80,69,84,80,68,69,63,75.0,76,84,83,12,6,16,15,8,,74+3,74+3,74+3,76,76,76,76,76,75+3,75+3,75+3,78+3,78+3,78+3,78+3,78+3,82+3,81+3,81+3,81+3,82+3,82+3,81+3,81+3,81+3,82+3,19+3,RB,239818,LCB|CB,88,91,107500000.0,230000.0,25,187,82,13.0,Right,4,2,3,Medium/High,Normal (185+),False,False,False,False,False,False,False,False,False,False,False,False,False,False,False,False,False,False,False,False,False,False,False,False,False,False,False,False,False,False,False,False,False,False,False,False,False,False,False,False,False,False,False,False,63.0,39.0,66.0,68.0,88.0,88.0,54,29,87,82,32,64,46,48,76,74,57,67,60,89,56,74,78,83,89,26,92,85,39,51,45,81.0,90,89,85,7,8,13,7,12,,61+3,61+3,61+3,59,60,60,60,59,62+3,62+3,62+3,64+3,70+3,70+3,70+3,64+3,78+3,83+3,83+3,83+3,78+3,80+3,87+3,87+3,87+3,80+3,18+3,CB,212218,RCB|CB,86,87,64500000.0,195000.0,28,191,85,13.0,Left,3,2,3,Medium/Medium,Unique,False,False,False,False,False,False,False,False,False,False,False,False,False,False,False,False,False,False,False,False,False,False,False,False,False,False,False,False,False,False,False,False,False,False,False,False,False,False,False,False,False,False,False,False,61.0,50.0,72.0,69.0,86.0,79.0,58,45,84,83,40,63,61,69,81,78,55,65,57,87,55,68,80,67,84,47,81,87,54,65,44,84.0,86,87,86,10,11,5,14,5,,66+3,66+3,66+3,64,66,66,66,64,68+3,68+3,68+3,67+3,74+3,74+3,74+3,67+3,77+3,82+3,82+3,82+3,77+3,78+3,85+2,85+2,85+2,78+3,18+3,CB,210514,LB|LWB,88,88,82500000.0,250000.0,28,182,74,13.0,Right,4,4,3,High/Medium,Unique,False,False,False,False,False,False,False,False,False,False,False,False,False,False,False,False,False,False,False,False,False,False,False,False,False,False,False,False,False,False,False,False,False,False,False,False,False,False,False,False,False,False,False,False,85.0,73.0,85.0,85.0,81.0,73.0,88,69,72,88,62,86,87,69,79,87,86,84,79,85,78,80,72,91,62,79,76,82,81,85,52,86.0,81,84,80,6,9,15,14,14,,78+3,78+3,78+3,84,83,83,83,84,84+3,84+3,84+3,85+3,84+3,84+3,84+3,85+3,85+3,83+3,83+3,83+3,85+3,84+3,79+3,79+3,79+3,84+3,19+3,LB,192985,CDM|CM,91,91,107500000.0,350000.0,31,181,70,13.0,Right,5,4,4,High/High,Unique,False,False,False,False,False,False,False,False,False,False,False,False,False,False,False,False,False,False,False,False,False,False,False,False,False,False,False,False,False,False,False,False,False,False,False,False,False,False,False,False,False,False,False,False,74.0,88.0,93.0,87.0,64.0,77.0,94,85,55,93,83,88,89,83,93,90,76,73,76,91,78,92,63,88,74,91,75,66,88,94,83,89.0,68,65,53,15,13,5,10,13,,83+3,83+3,83+3,88,87,87,87,88,89+2,89+2,89+2,88+3,89+2,89+2,89+2,88+3,79+3,79+3,79+3,79+3,79+3,75+3,69+3,69+3,69+3,75+3,21+3,CM,231866,CDM|CM,87,89,88500000.0,200000.0,26,191,82,13.0,Right,4,3,3,Medium/High,Normal (185+),False,False,False,False,False,False,False,False,False,False,False,False,False,False,False,False,False,False,False,False,False,False,False,False,False,False,False,False,False,False,False,False,False,False,False,False,False,False,False,False,False,False,False,False,58.0,72.0,78.0,79.0,83.0,84.0,63,64,80,86,59,78,65,61,83,85,54,62,65,82,65,89,72,88,84,82,82,83,75,83,46,85.0,84,86,78,10,10,7,14,8,,76+3,76+3,76+3,74,77,77,77,74,79+3,79+3,79+3,76+3,83+3,83+3,83+3,76+3,79+3,84+3,84+3,84+3,79+3,79+3,82+3,82+3,82+3,79+3,18+3,CDM,186942,CDM|CM,85,85,44000000.0,185000.0,31,180,80,13.0,Right,4,4,3,High/Medium,Normal (170-185),False,False,False,False,False,False,False,False,False,False,False,False,False,False,False,False,False,False,False,False,False,False,False,False,False,False,False,False,False,False,False,False,False,False,False,False,False,False,False,False,False,False,False,False,64.0,80.0,85.0,85.0,72.0,72.0,78,81,50,88,75,85,86,80,85,90,66,63,77,86,77,79,61,74,73,81,70,75,83,86,80,87.0,76,75,67,11,14,5,5,13,,78+3,78+3,78+3,82,82,82,82,82,84+1,84+1,84+1,82+3,84+1,84+1,84+1,82+3,77+3,80+3,80+3,80+3,77+3,75+3,72+3,72+3,72+3,75+3,19+3,CM,218667,CAM|CF,88,88,97500000.0,260000.0,27,173,64,13.0,Left,3,4,2,High/High,Lean (170-185),False,False,False,False,False,False,False,False,False,False,False,False,False,False,False,False,False,False,False,False,False,False,False,False,False,False,False,False,False,False,False,False,False,False,False,False,False,False,False,False,False,False,False,False,77.0,78.0,84.0,92.0,61.0,68.0,85,79,51,89,78,92,85,67,77,91,84,71,94,87,92,79,51,93,54,78,75,60,83,85,68,90.0,59,71,53,9,10,14,12,9,,78+2,78+2,78+2,86,84,84,84,86,86+2,86+2,86+2,86+2,84+2,84+2,84+2,86+2,77+2,75+2,75+2,75+2,77+2,73+2,65+2,65+2,65+2,73+2,19+2,CAM,237692,CAM|CF,85,92,109500000.0,180000.0,22,171,69,13.0,Left,3,4,3,High/High,Lean (170-185),False,False,False,False,False,False,False,False,False,False,False,False,False,False,False,False,False,False,False,False,False,False,False,False,False,False,False,False,False,False,False,False,False,False,False,False,False,False,False,False,False,False,False,False,82.0,78.0,81.0,88.0,56.0,60.0,76,79,47,85,59,87,73,68,81,91,86,78,91,83,91,82,49,83,47,77,64,59,82,85,64,84.0,58,59,47,8,15,6,10,13,,77+3,77+3,77+3,84,83,83,83,84,85+3,85+3,85+3,84+3,82+3,82+3,82+3,84+3,72+3,71+3,71+3,71+3,72+3,69+3,59+3,59+3,59+3,69+3,19+3,LW,239085,CF|ST,88,94,148000000.0,220000.0,21,195,94,13.0,Left,3,3,4,High/Medium,Unique,False,False,False,False,False,False,False,False,False,False,False,False,False,False,False,False,False,False,False,False,False,False,False,False,False,False,False,False,False,False,False,False,False,False,False,False,False,False,False,False,False,False,False,False,89.0,91.0,65.0,80.0,49.0,87.0,47,94,79,74,88,78,77,62,53,82,82,94,76,88,72,94,74,81,93,87,85,43,89,74,76,85.0,44,53,29,7,14,13,11,7,,87+3,87+3,87+3,80,84,84,84,80,80+3,80+3,80+3,77+3,73+3,73+3,73+3,77+3,62+3,64+3,64+3,64+3,62+3,61+3,62+3,62+3,62+3,61+3,19+3,ST
1,11.0,2022.0,4-3-1-2,to_be_implemented,193080,GK,87,87,42000000.0,150000.0,31,192,76,13.0,Right,3,1,4,Medium/Medium,Unique,False,False,False,False,False,False,False,False,False,False,False,False,False,False,False,False,False,False,False,False,False,False,False,False,False,False,False,False,False,False,False,False,False,False,False,False,False,False,False,False,False,False,False,False,,,,,,,17,13,21,48,13,18,21,19,50,34,52,50,63,89,43,57,67,43,55,12,30,30,12,53,29,58.0,25,21,13,88,80,76,84,89,51.0,34+3,34+3,34+3,34,36,36,36,34,39+3,39+3,39+3,37+3,41+3,41+3,41+3,37+3,35+3,39+3,39+3,39+3,35+3,35+3,33+3,33+3,33+3,35+3,85+2,GK,229880,RB|RWB,80,83,26500000.0,90000.0,24,183,72,13.0,Right,2,3,2,Medium/Medium,Unique,False,False,False,False,False,False,False,False,False,False,False,False,False,False,False,False,False,False,False,False,False,False,False,False,False,False,False,False,False,False,False,False,False,False,False,False,False,False,False,False,False,False,False,False,82.0,50.0,66.0,75.0,78.0,73.0,70,44,50,72,43,76,72,45,58,72,77,86,80,76,71,70,67,77,71,44,75,82,69,63,44,72.0,75,84,90,9,8,6,8,8,,64+2,64+2,64+2,69,68,68,68,69,68+2,68+2,68+2,71+2,69+2,69+2,69+2,71+2,78+2,75+2,75+2,75+2,78+2,78+2,76+2,76+2,76+2,78+2,16+2,RB,201535,LCB|CB,84,85,39000000.0,155000.0,29,191,81,13.0,Right,4,2,3,Medium/High,Unique,False,False,False,False,False,False,False,False,False,False,False,False,False,False,False,False,False,False,False,False,False,False,False,False,False,False,False,False,False,False,False,False,False,False,False,False,False,False,False,False,False,False,False,False,81.0,49.0,64.0,66.0,85.0,80.0,42,46,85,78,42,61,46,52,77,75,77,84,62,82,39,52,80,67,87,53,78,84,55,59,43,82.0,85,86,83,11,11,9,5,14,,65+3,65+3,65+3,64,66,66,66,64,67+3,67+3,67+3,66+3,71+3,71+3,71+3,66+3,75+3,80+3,80+3,80+3,75+3,78+3,83+2,83+2,83+2,78+3,18+3,CB,203263,RCB|CB,81,82,24000000.0,120000.0,29,194,100,13.0,Right,3,2,3,High/Medium,Stocky (185+),False,False,False,False,False,False,False,False,False,False,False,False,False,False,False,False,False,False,False,False,False,False,False,False,False,False,False,False,False,False,False,False,False,False,False,False,False,False,False,False,False,False,False,False,48.0,57.0,68.0,67.0,80.0,84.0,51,48,85,78,49,71,57,46,80,73,44,52,39,77,33,82,87,70,90,52,84,82,61,68,68,77.0,77,82,76,14,16,9,14,9,,67+3,67+3,67+3,62,66,66,66,62,67+3,67+3,67+3,65+3,73+3,73+3,73+3,65+3,71+3,78+3,78+3,78+3,71+3,72+3,81+1,81+1,81+1,72+3,20+3,CB,205988,LB|LWB,80,81,22500000.0,105000.0,26,181,75,13.0,Left,2,3,2,Medium/Medium,Stocky (170-185),False,False,False,False,False,False,False,False,False,False,False,False,False,False,False,False,False,False,False,False,False,False,False,False,False,False,False,False,False,False,False,False,False,False,False,False,False,False,False,False,False,False,False,False,76.0,54.0,78.0,78.0,79.0,78.0,82,44,76,80,56,78,83,54,70,80,74,77,70,76,78,74,83,72,77,54,85,78,76,80,38,81.0,79,81,78,10,12,13,7,7,,70+2,70+2,70+2,74,73,73,73,74,74+2,74+2,74+2,76+2,76+2,76+2,76+2,76+2,78+2,78+2,78+2,78+2,78+2,78+2,79+2,79+2,79+2,78+2,17+2,LB,200145,CDM|CM,89,89,86000000.0,240000.0,30,185,84,13.0,Right,3,2,3,Medium/High,Unique,False,False,False,False,False,False,False,False,False,False,False,False,False,False,False,False,False,False,False,False,False,False,False,False,False,False,False,False,False,False,False,False,False,False,False,False,False,False,False,False,False,False,False,False,63.0,73.0,75.0,72.0,87.0,90.0,58,64,79,84,62,67,62,74,83,78,60,66,61,87,66,88,85,90,90,81,91,88,75,75,66,84.0,87,88,87,13,14,16,12,12,,75+3,75+3,75+3,71,75,75,75,71,75+3,75+3,75+3,73+3,81+3,81+3,81+3,73+3,80+3,86+3,86+3,86+3,80+3,81+3,86+3,86+3,86+3,81+3,21+3,CDM,190460,CDM|CM,82,82,29000000.0,135000.0,30,181,76,13.0,Right,5,4,3,Medium/Low,Unique,False,False,False,False,False,False,False,False,False,False,False,False,False,False,False,False,False,False,False,False,False,False,False,False,False,False,False,False,False,False,False,False,False,False,False,False,False,False,False,False,False,False,False,False,61.0,78.0,88.0,80.0,53.0,52.0,86,73,52,89,80,77,89,87,90,89,63,60,68,79,78,84,49,59,52,85,46,56,74,86,67,87.0,59,57,22,9,14,7,7,6,,74+3,74+3,74+3,79,79,79,79,79,81+1,81+1,81+1,79+3,81+1,81+1,81+1,79+3,66+3,68+3,68+3,68+3,66+3,61+3,56+3,56+3,56+3,61+3,17+3,CM,209297,CDM|CM,80,80,20500000.0,120000.0,29,169,62,13.0,Left,3,4,3,High/High,Lean (170-),False,False,False,False,False,False,False,False,False,False,False,False,False,False,False,False,False,False,False,False,False,False,False,False,False,False,False,False,False,False,False,False,False,False,False,False,False,False,False,False,False,False,False,False,76.0,67.0,79.0,81.0,75.0,71.0,74,61,56,83,62,80,78,74,80,80,78,74,89,87,88,78,82,94,52,68,85,83,73,76,64,75.0,72,81,70,7,16,15,11,15,,71+3,71+3,71+3,77,76,76,76,77,78+2,78+2,78+2,78+2,80,80,80,78+2,80,80,80,80,80,78+2,74+3,74+3,74+3,78+2,21+3,CM,212198,CAM|CF,86,86,72500000.0,190000.0,27,179,69,13.0,Right,3,4,3,High/High,Unique,False,False,False,False,False,False,False,False,False,False,False,False,False,False,False,False,False,False,False,False,False,False,False,False,False,False,False,False,False,False,False,False,False,False,False,False,False,False,False,False,False,False,False,False,72.0,86.0,88.0,81.0,67.0,76.0,85,83,64,88,87,79,87,85,88,84,75,69,78,91,79,88,71,92,66,88,80,64,86,91,90,79.0,66,73,65,12,14,15,8,14,,81+3,81+3,81+3,83,84,84,84,83,85+1,85+1,85+1,84+2,86,86,86,84+2,78+3,79+3,79+3,79+3,78+3,76+3,71+3,71+3,71+3,76+3,21+3,CAM,20801,CF|ST,90,90,41000000.0,220000.0,37,187,83,13.0,Right,4,5,5,High/Low,Unique,False,False,False,False,False,False,False,False,False,False,False,False,False,False,False,False,False,False,False,False,False,False,False,False,False,False,False,False,False,False,False,False,False,False,False,False,False,False,False,False,False,False,False,False,81.0,92.0,78.0,85.0,34.0,75.0,80,93,90,80,86,85,81,79,75,88,79,83,77,94,67,93,95,76,77,90,63,29,95,76,90,95.0,24,32,24,7,11,15,14,11,,89+1,89+1,89+1,86,88,88,88,86,85+3,85+3,85+3,84+3,78+3,78+3,78+3,84+3,62+3,59+3,59+3,59+3,62+3,58+3,53+3,53+3,53+3,58+3,20+3,ST,211300,CF|ST,80,83,28000000.0,125000.0,26,184,76,13.0,Right,4,4,3,Low/Low,Unique,False,False,False,False,False,False,False,False,False,False,False,False,False,False,False,False,False,False,False,False,False,False,False,False,False,False,False,False,False,False,False,False,False,False,False,False,False,False,False,False,False,False,False,False,83.0,79.0,72.0,84.0,35.0,66.0,73,79,70,77,76,87,84,54,60,84,85,82,79,78,79,83,72,62,73,74,54,34,78,75,80,78.0,26,33,31,9,8,8,15,11,,79+3,79+3,79+3,80,80,80,80,80,79+3,79+3,79+3,78+3,71+3,71+3,71+3,78+3,59+3,56+3,56+3,56+3,59+3,56+3,50+3,50+3,50+3,56+3,18+3,ST
2,9.0,2022.0,4-3-2-1,to_be_implemented,212831,GK,89,90,79000000.0,190000.0,29,191,91,13.0,Right,3,1,3,Medium/Medium,Unique,False,False,False,False,False,False,False,False,False,False,False,False,False,False,False,False,False,False,False,False,False,False,False,False,False,False,False,False,False,False,False,False,False,False,False,False,False,False,False,False,False,False,False,False,,,,,,,17,13,29,60,20,27,19,18,58,40,58,49,40,87,37,64,52,32,78,14,27,11,13,66,23,68.0,15,19,16,86,85,85,90,89,54.0,39+3,39+3,39+3,38,41,41,41,38,45+3,45+3,45+3,42+3,46+3,46+3,46+3,42+3,33+3,39+3,39+3,39+3,33+3,32+3,32+3,32+3,32+3,32+3,87+3,GK,231281,RB|RWB,87,90,100500000.0,150000.0,23,180,69,13.0,Right,4,3,3,High/Medium,Unique,False,False,False,False,False,False,False,False,False,False,False,False,False,False,False,False,False,False,False,False,False,False,False,False,False,False,False,False,False,False,False,False,False,False,False,False,False,False,False,False,False,False,False,False,76.0,69.0,89.0,80.0,80.0,73.0,92,62,69,87,63,78,87,85,91,86,76,76,73,83,73,82,66,89,66,75,71,83,78,90,55,82.0,79,83,80,14,15,14,6,7,,75+3,75+3,75+3,80,79,79,79,80,82+3,82+3,82+3,83+3,85+3,85+3,85+3,83+3,84+3,84+3,84+3,84+3,84+3,83+3,78+3,78+3,78+3,83+3,19+3,RB,203376,LCB|CB,90,90,98000000.0,230000.0,30,193,92,13.0,Right,3,2,4,Medium/High,Unique,False,False,False,False,False,False,False,False,False,False,False,False,False,False,False,False,False,False,False,False,False,False,False,False,False,False,False,False,False,False,False,False,False,False,False,False,False,False,False,False,False,False,False,False,81.0,60.0,71.0,72.0,91.0,86.0,53,52,87,79,45,70,60,70,86,76,68,91,61,89,53,81,88,74,93,64,85,90,47,65,62,90.0,92,92,86,13,10,13,11,11,,71+3,71+3,71+3,68,70,70,70,68,70+3,70+3,70+3,70+3,76+3,76+3,76+3,70+3,80+3,85+3,85+3,85+3,80+3,82+3,89+1,89+1,89+1,82+3,20+3,CB,197061,RCB|CB,84,84,34500000.0,140000.0,30,194,90,13.0,Right,2,2,2,Medium/Medium,Lean (185+),False,False,False,False,False,False,False,False,False,False,False,False,False,False,False,False,False,False,False,False,False,False,False,False,False,False,False,False,False,False,False,False,False,False,False,False,False,False,False,False,False,False,False,False,61.0,46.0,69.0,71.0,87.0,78.0,54,36,84,80,50,74,63,23,74,74,53,67,55,86,42,66,78,67,82,48,84,86,48,72,42,80.0,88,88,82,11,15,10,7,10,,63+2,63+2,63+2,64,65,65,65,64,68+2,68+2,68+2,67+2,73+2,73+2,73+2,67+2,76+2,81+2,81+2,81+2,76+2,77+2,84,84,84,77+2,19+2,CB,216267,LB|LWB,87,87,72000000.0,185000.0,28,178,64,13.0,Left,2,3,3,High/High,Unique,False,False,False,False,False,False,False,False,False,False,False,False,False,False,False,False,False,False,False,False,False,False,False,False,False,False,False,False,False,False,False,False,False,False,False,False,False,False,False,False,False,False,False,False,80.0,61.0,81.0,81.0,82.0,76.0,88,55,67,82,32,81,82,71,76,83,79,81,75,85,74,76,62,95,65,65,85,84,77,80,55,83.0,83,84,82,11,8,10,7,14,,72+3,72+3,72+3,78,77,77,77,78,78+3,78+3,78+3,81+3,81+3,81+3,81+3,81+3,85+2,82+3,82+3,82+3,85+2,84+3,79+3,79+3,79+3,84+3,18+3,LB,209499,CDM|CM,87,88,77000000.0,185000.0,28,188,78,13.0,Right,2,3,3,Medium/High,Unique,False,False,False,False,False,False,False,False,False,False,False,False,False,False,False,False,False,False,False,False,False,False,False,False,False,False,False,False,False,False,False,False,False,False,False,False,False,False,False,False,False,False,False,False,66.0,69.0,78.0,77.0,86.0,83.0,75,63,75,84,47,78,71,53,82,81,64,68,63,86,64,81,75,88,81,70,85,88,70,76,90,85.0,86,88,86,13,12,6,8,8,,74+3,74+3,74+3,75,75,75,75,75,76+3,76+3,76+3,77+3,81+3,81+3,81+3,77+3,82+3,85+3,85+3,85+3,82+3,82+3,84+3,84+3,84+3,82+3,18+3,CDM,189509,CDM|CM,86,86,55500000.0,180000.0,31,174,70,13.0,Right,3,5,3,Medium/Medium,Normal (170-185),False,False,False,False,False,False,False,False,False,False,False,False,False,False,False,False,False,False,False,False,False,False,False,False,False,False,False,False,False,False,False,False,False,False,False,False,False,False,False,False,False,False,False,False,61.0,72.0,87.0,90.0,72.0,69.0,78,68,54,91,82,89,85,77,89,92,69,55,90,84,90,75,86,76,60,73,80,82,75,88,75,90.0,68,74,74,6,11,7,9,13,,74+3,74+3,74+3,81,80,80,80,81,84+2,84+2,84+2,82+3,85+1,85+1,85+1,82+3,78+3,81+3,81+3,81+3,78+3,76+3,73+3,73+3,73+3,76+3,18+3,CM,183711,CDM|CM,83,83,28500000.0,135000.0,32,182,80,13.0,Right,3,3,3,High/High,Normal (170-185),False,False,False,False,False,False,False,False,False,False,False,False,False,False,False,False,False,False,False,False,False,False,False,False,False,False,False,False,False,False,False,False,False,False,False,False,False,False,False,False,False,False,False,False,66.0,74.0,83.0,78.0,78.0,81.0,82,73,64,85,71,78,80,74,87,83,66,66,66,85,67,77,78,86,78,75,83,81,78,80,64,80.0,77,81,76,7,13,7,9,13,,76+3,76+3,76+3,78,78,78,78,78,79+3,79+3,79+3,79+3,82+1,82+1,82+1,79+3,80+3,82+1,82+1,82+1,80+3,79+3,78+3,78+3,78+3,79+3,19+3,CM,224458,CAM|CF,85,89,76000000.0,170000.0,25,178,73,13.0,Right,5,4,2,High/High,Normal (170-185),False,False,False,False,False,False,False,False,False,False,False,False,False,False,False,False,False,False,False,False,False,False,False,False,False,False,False,False,False,False,False,False,False,False,False,False,False,False,False,False,False,False,False,False,85.0,83.0,75.0,85.0,57.0,77.0,73,86,84,77,79,85,77,58,72,84,88,82,86,87,85,85,81,83,71,75,85,56,89,77,69,80.0,53,57,45,7,12,15,9,11,,84+2,84+2,84+2,83,84,84,84,83,82+2,82+2,82+2,82+2,78+2,78+2,78+2,82+2,70+2,69+2,69+2,69+2,70+2,68+2,66+2,66+2,66+2,68+2,19+2,CF,201942,CAM|CF,83,83,35500000.0,150000.0,30,181,76,13.0,Right,4,5,3,High/High,Unique,False,False,False,False,False,False,False,False,False,False,False,False,False,False,False,False,False,False,False,False,False,False,False,False,False,False,False,False,False,False,False,False,False,False,False,False,False,False,False,False,False,False,False,False,74.0,76.0,79.0,87.0,59.0,78.0,73,76,78,84,79,87,81,65,76,88,75,74,84,85,86,77,81,87,74,76,75,58,82,83,72,88.0,55,64,42,8,11,9,6,10,,80+3,80+3,80+3,82,82,82,82,82,83,83,83,82+1,81+2,81+2,81+2,82+1,71+3,72+3,72+3,72+3,71+3,69+3,67+3,67+3,67+3,69+3,17+3,CF,253072,CF|ST,82,89,61500000.0,120000.0,23,186,80,13.0,Right,3,3,1,High/High,Lean (185+),False,False,False,False,False,False,False,False,False,False,False,False,False,False,False,False,False,False,False,False,False,False,False,False,False,False,False,False,False,False,False,False,False,False,False,False,False,False,False,False,False,False,False,False,89.0,82.0,68.0,77.0,42.0,86.0,67,83,76,69,78,76,75,61,60,77,91,88,78,84,67,86,76,89,88,75,78,41,84,71,78,83.0,36,39,33,14,10,12,10,13,,82+2,82+2,82+2,78,79,79,79,78,76+2,76+2,76+2,77+2,71+2,71+2,71+2,77+2,63+2,60+2,60+2,60+2,63+2,61+2,57+2,57+2,57+2,61+2,20+2,ST
3,18.0,2022.0,3-5-2,to_be_implemented,167948,GK,87,87,9000000.0,80000.0,35,188,82,13.0,Left,1,1,4,Medium/Medium,Unique,False,False,False,False,False,False,False,False,False,False,False,False,False,False,False,False,False,False,False,False,False,False,False,False,False,False,False,False,False,False,False,False,False,False,False,False,False,False,False,False,False,False,False,False,,,,,,,13,10,9,54,15,12,12,10,55,29,61,62,54,84,56,56,74,41,43,14,31,25,9,59,40,59.0,24,12,18,88,83,74,84,88,61.0,31+3,31+3,31+3,33,35,35,35,33,39+3,39+3,39+3,37+3,41+3,41+3,41+3,37+3,34+3,38+3,38+3,38+3,34+3,33+3,29+3,29+3,29+3,33+3,85+2,GK,232488,RCB|CB,83,88,49500000.0,95000.0,24,185,79,13.0,Right,2,3,3,Medium/High,Normal (185+),False,False,False,False,False,False,False,False,False,False,False,False,False,False,False,False,False,False,False,False,False,False,False,False,False,False,False,False,False,False,False,False,False,False,False,False,False,False,False,False,False,False,False,False,73.0,46.0,57.0,65.0,85.0,82.0,42,48,83,74,52,59,54,38,64,68,75,72,67,82,68,51,85,74,82,36,90,82,43,41,40,80.0,86,86,85,5,7,11,10,14,,62+3,62+3,62+3,59,60,60,60,59,60+3,60+3,60+3,61+3,64+3,64+3,64+3,61+3,74+3,77+3,77+3,77+3,74+3,76+3,83+3,83+3,83+3,76+3,17+3,CB,202335,CB,80,81,20000000.0,90000.0,28,188,90,13.0,Right,2,2,2,Medium/High,Stocky (185+),False,False,False,False,False,False,False,False,False,False,False,False,False,False,False,False,False,False,False,False,False,False,False,False,False,False,False,False,False,False,False,False,False,False,False,False,False,False,False,False,False,False,False,False,54.0,64.0,70.0,65.0,80.0,84.0,64,52,82,74,51,65,68,76,76,72,53,55,36,79,46,84,71,70,91,74,88,76,53,64,74,76.0,79,81,82,11,14,6,13,9,,67+2,67+2,67+2,63,66,66,66,63,66+2,66+2,66+2,65+2,71+2,71+2,71+2,65+2,72+2,77+2,77+2,77+2,72+2,74+2,80+1,80+1,80+1,74+2,19+2,CB,205923,LCB|CB,79,79,14500000.0,85000.0,29,181,76,13.0,Left,3,3,2,Medium/Medium,Normal (170-185),False,False,False,False,False,False,False,False,False,False,False,False,False,False,False,False,False,False,False,False,False,False,False,False,False,False,False,False,False,False,False,False,False,False,False,False,False,False,False,False,False,False,False,False,67.0,58.0,72.0,72.0,80.0,74.0,71,58,73,78,48,70,72,48,75,77,68,67,64,83,69,65,78,76,70,52,81,81,60,65,54,76.0,82,81,80,11,7,6,7,14,,67+2,67+2,67+2,69,69,69,69,69,70+2,70+2,70+2,71+2,73+2,73+2,73+2,71+2,77+2,78+1,78+1,78+1,77+2,77+2,79,79,79,77+2,18+2,CB,247204,RM|RWB|RB,78,82,18500000.0,63000.0,23,181,79,13.0,Right,3,3,1,High/Medium,Lean (170-185),False,False,False,False,False,False,False,False,False,False,False,False,False,False,False,False,False,False,False,False,False,False,False,False,False,False,False,False,False,False,False,False,False,False,False,False,False,False,False,False,False,False,False,False,74.0,62.0,71.0,74.0,75.0,76.0,75,57,70,77,44,74,73,47,65,77,73,75,74,72,67,77,79,76,74,62,80,73,73,65,48,65.0,75,78,79,11,13,9,10,13,,70+2,70+2,70+2,72,71,71,71,72,71+2,71+2,71+2,73+2,72+2,72+2,72+2,73+2,76+2,74+2,74+2,74+2,76+2,75+2,76+2,76+2,76+2,75+2,18+2,RWB,213648,CDM|CM,83,85,40500000.0,110000.0,26,187,84,13.0,Right,4,3,2,High/High,Normal (185+),False,False,False,False,False,False,False,False,False,False,False,False,False,False,False,False,False,False,False,False,False,False,False,False,False,False,False,False,False,False,False,False,False,False,False,False,False,False,False,False,False,False,False,False,55.0,73.0,77.0,77.0,80.0,82.0,68,68,65,83,64,78,70,74,81,80,56,54,65,84,67,85,65,87,79,80,87,82,68,73,56,84.0,83,84,72,9,7,12,11,11,,73+2,73+2,73+2,73,74,74,74,73,75+2,75+2,75+2,74+2,80+2,80+2,80+2,74+2,77+2,82+2,82+2,82+2,77+2,76+2,79+2,79+2,79+2,76+2,18+2,CDM,236480,CDM|CM,81,86,34500000.0,88000.0,25,182,80,13.0,Right,3,4,1,High/Medium,Lean (170-185),False,False,False,False,False,False,False,False,False,False,False,False,False,False,False,False,False,False,False,False,False,False,False,False,False,False,False,False,False,False,False,False,False,False,False,False,False,False,False,False,False,False,False,False,72.0,68.0,75.0,79.0,80.0,77.0,65,58,65,82,65,81,62,75,78,79,71,73,73,79,77,83,80,82,75,79,77,83,68,76,58,80.0,80,85,78,12,8,8,12,8,,72+2,72+2,72+2,74,75,75,75,74,76+2,76+2,76+2,75+2,79+2,79+2,79+2,75+2,78+2,80+2,80+2,80+2,78+2,78+2,79+2,79+2,79+2,78+2,17+2,CDM,227535,CDM|CM,79,83,24500000.0,85000.0,25,187,73,13.0,Right,4,4,2,Medium/Medium,Lean (185+),False,False,False,False,False,False,False,False,False,False,False,False,False,False,False,False,False,False,False,False,False,False,False,False,False,False,False,False,False,False,False,False,False,False,False,False,False,False,False,False,False,False,False,False,67.0,62.0,79.0,80.0,78.0,77.0,76,55,62,83,71,82,71,68,81,83,66,68,70,77,74,69,73,86,72,65,78,78,64,78,64,81.0,79,81,78,8,7,14,14,12,,69+2,69+2,69+2,74,73,73,73,74,76+2,76+2,76+2,76+2,79+2,79+2,79+2,76+2,79+2,80+2,80+2,80+2,79+2,78+2,77+2,77+2,77+2,78+2,18+2,CM,181458,LM|LWB|LB,84,84,26500000.0,130000.0,33,186,80,13.0,Right,5,4,3,High/Medium,Lean (185+),False,False,False,False,False,False,False,False,False,False,False,False,False,False,False,False,False,False,False,False,False,False,False,False,False,False,False,False,False,False,False,False,False,False,False,False,False,False,False,False,False,False,False,False,78.0,81.0,79.0,82.0,74.0,78.0,85,80,80,79,81,83,78,75,79,82,79,78,76,85,75,84,87,84,80,78,65,72,85,76,76,88.0,80,70,68,6,7,10,9,6,,82+2,82+2,82+2,81,81,81,81,81,80+3,80+3,80+3,82+2,80+3,80+3,80+3,82+2,78+3,77+3,77+3,77+3,78+3,77+3,75+3,75+3,75+3,77+3,16+3,LM,202126,CF|ST,89,89,105500000.0,240000.0,28,188,89,13.0,Right,5,3,4,High/High,Unique,False,False,False,False,False,False,False,False,False,False,False,False,False,False,False,False,False,False,False,False,False,False,False,False,False,False,False,False,False,False,False,False,False,False,False,False,False,False,False,False,False,False,False,False,68.0,91.0,83.0,82.0,47.0,82.0,80,93,85,84,87,83,82,65,85,84,67,69,68,92,71,92,79,83,83,86,80,44,94,87,92,92.0,50,36,38,8,10,11,14,11,,87+2,87+2,87+2,84,86,86,86,84,85+3,85+3,85+3,83+3,81+3,81+3,81+3,83+3,66+3,68+3,68+3,68+3,66+3,63+3,61+3,61+3,61+3,63+3,20+3,ST,231943,CF|ST,81,84,34500000.0,105000.0,25,181,71,13.0,Right,5,4,3,High/Medium,Normal (170-185),False,False,False,False,False,False,False,False,False,False,False,False,False,False,False,False,False,False,False,False,False,False,False,False,False,False,False,False,False,False,False,False,False,False,False,False,False,False,False,False,False,False,False,False,82.0,79.0,72.0,82.0,53.0,79.0,73,81,82,77,74,84,74,65,61,82,85,79,79,80,71,83,86,81,76,72,84,46,81,74,77,81.0,45,58,48,12,7,8,11,13,,81+3,81+3,81+3,80,80,80,80,80,79+3,79+3,79+3,79+3,74+3,74+3,74+3,79+3,68+3,66+3,66+3,66+3,68+3,66+3,64+3,64+3,64+3,66+3,18+3,ST
4,5.0,2022.0,4-3-2-1,to_be_implemented,234642,GK,86,87,51000000.0,130000.0,30,197,86,13.0,Right,2,1,2,Medium/Medium,Lean (185+),False,False,False,False,False,False,False,False,False,False,False,False,False,False,False,False,False,False,False,False,False,False,False,False,False,False,False,False,False,False,False,False,False,False,False,False,False,False,False,False,False,False,False,False,,,,,,,10,5,10,47,9,18,13,14,54,31,33,36,50,84,33,61,39,37,72,9,22,13,6,52,13,58.0,10,11,13,84,82,81,85,88,34.0,29+2,29+2,29+2,29,32,32,32,29,35+2,35+2,35+2,32+2,38+2,38+2,38+2,32+2,28+2,34+2,34+2,34+2,28+2,26+2,26+2,26+2,26+2,26+2,84+2,GK,238074,RB|RWB,84,88,57000000.0,120000.0,22,178,87,13.0,Right,3,3,2,High/Medium,Stocky (170-185),False,False,False,False,False,False,False,False,False,False,False,False,False,False,False,False,False,False,False,False,False,False,False,False,False,False,False,False,False,False,False,False,False,False,False,False,False,False,False,False,False,False,False,False,81.0,70.0,82.0,82.0,80.0,82.0,88,66,71,82,62,83,82,76,78,81,79,83,75,81,88,83,75,83,85,69,74,78,77,80,52,82.0,81,83,79,8,12,7,13,11,,77+2,77+2,77+2,79,79,79,79,79,79+2,79+2,79+2,81+2,80+2,80+2,80+2,81+2,82+2,80+2,80+2,80+2,82+2,81+2,80+2,80+2,80+2,81+2,19+2,RWB,201024,LCB|CB,87,87,54500000.0,175000.0,31,187,89,13.0,Right,4,2,3,Medium/High,Unique,False,False,False,False,False,False,False,False,False,False,False,False,False,False,False,False,False,False,False,False,False,False,False,False,False,False,False,False,False,False,False,False,False,False,False,False,False,False,False,False,False,False,False,False,82.0,33.0,59.0,68.0,88.0,85.0,38,25,84,71,14,70,53,28,67,72,74,88,51,83,34,67,82,70,94,20,83,85,35,60,33,82.0,90,89,86,7,11,7,13,5,,59+3,59+3,59+3,59,60,60,60,59,61+3,61+3,61+3,63+3,67+3,67+3,67+3,63+3,75+3,79+3,79+3,79+3,75+3,78+3,86+1,86+1,86+1,78+3,17+3,CB,164240,RCB|CB,86,86,12000000.0,115000.0,37,183,79,13.0,Right,3,2,4,Medium/High,Normal (170-185),False,False,False,False,False,False,False,False,False,False,False,False,False,False,False,False,False,False,False,False,False,False,False,False,False,False,False,False,False,False,False,False,False,False,False,False,False,False,False,False,False,False,False,False,49.0,54.0,73.0,72.0,87.0,76.0,60,40,82,81,61,67,62,61,82,79,45,52,62,83,66,71,88,66,80,65,76,89,59,71,60,86.0,89,86,84,9,12,5,9,10,,65+3,65+3,65+3,65,66,66,66,65,69+3,69+3,69+3,67+3,76+3,76+3,76+3,67+3,75+3,82+3,82+3,82+3,75+3,77+3,84+2,84+2,84+2,77+3,18+3,CB,229984,LB|LWB,82,85,37000000.0,110000.0,25,180,77,13.0,Left,3,3,2,High/Medium,Normal (170-185),False,False,False,False,False,False,False,False,False,False,False,False,False,False,False,False,False,False,False,False,False,False,False,False,False,False,False,False,False,False,False,False,False,False,False,False,False,False,False,False,False,False,False,False,76.0,60.0,78.0,78.0,78.0,75.0,84,58,69,80,65,79,71,67,74,81,77,75,69,81,72,74,86,86,69,47,73,76,78,75,52,75.0,78,80,82,10,7,14,7,10,,72+2,72+2,72+2,76,75,75,75,76,75+2,75+2,75+2,78+2,77+2,77+2,77+2,78+2,80+2,78+2,78+2,78+2,80+2,80+2,77+2,77+2,77+2,80+2,17+2,LWB,215914,CDM|CM,89,89,72000000.0,220000.0,31,168,70,13.0,Right,3,2,4,Medium/High,Unique,False,False,False,False,False,False,False,False,False,False,False,False,False,False,False,False,False,False,False,False,False,False,False,False,False,False,False,False,False,False,False,False,False,False,False,False,False,False,False,False,False,False,False,False,72.0,66.0,74.0,81.0,87.0,82.0,68,65,54,82,56,78,49,49,76,81,77,68,78,93,92,71,75,95,72,65,93,91,72,77,54,84.0,90,93,86,15,12,10,7,10,,72+3,72+3,72+3,76,76,76,76,76,77+3,77+3,77+3,78+3,81+3,81+3,81+3,78+3,84+3,86+3,86+3,86+3,84+3,84+3,84+3,84+3,84+3,84+3,20+3,CDM,205498,CDM|CM,85,85,51500000.0,165000.0,30,180,68,13.0,Right,3,3,2,Medium/Medium,Lean (170-185),False,False,False,False,False,False,False,False,False,False,False,False,False,False,False,False,False,False,False,False,False,False,False,False,False,False,False,False,False,False,False,False,False,False,False,False,False,False,False,False,False,False,False,False,54.0,67.0,86.0,81.0,73.0,73.0,75,64,56,92,71,79,75,76,89,87,63,47,75,82,72,71,58,87,66,62,79,81,69,88,89,84.0,67,81,71,14,7,13,14,8,,70+2,70+2,70+2,75,75,75,75,75,80+2,80+2,80+2,78+2,84+1,84+1,84+1,78+2,78+2,82+2,82+2,82+2,78+2,75+2,73+2,73+2,73+2,75+2,19+2,CM,207410,CDM|CM,84,84,42000000.0,155000.0,28,176,80,13.0,Right,4,4,3,High/High,Normal (170-185),False,False,False,False,False,False,False,False,False,False,False,False,False,False,False,False,False,False,False,False,False,False,False,False,False,False,False,False,False,False,False,False,False,False,False,False,False,False,False,False,False,False,False,False,70.0,69.0,83.0,88.0,71.0,71.0,73,61,42,90,76,89,79,70,84,89,77,65,86,82,84,79,75,79,65,75,77,75,73,86,59,84.0,73,76,68,9,5,6,7,7,,72+3,72+3,72+3,80,79,79,79,80,83+1,83+1,83+1,81+3,84,84,84,81+3,78+3,80+3,80+3,80+3,78+3,75+3,71+3,71+3,71+3,75+3,15+3,CM,233064,CAM|CF,84,87,57500000.0,130000.0,23,180,74,13.0,Right,4,3,3,High/High,Lean (170-185),False,False,False,False,False,False,False,False,False,False,False,False,False,False,False,False,False,False,False,False,False,False,False,False,False,False,False,False,False,False,False,False,False,False,False,False,False,False,False,False,False,False,False,False,74.0,81.0,85.0,82.0,55.0,67.0,83,81,59,87,75,82,82,84,84,85,76,72,77,84,76,81,54,86,58,83,68,59,82,83,69,84.0,55,57,41,11,12,13,8,12,,78+3,78+3,78+3,82,82,82,82,82,83+3,83+3,83+3,82+3,82+3,82+3,82+3,82+3,71+3,71+3,71+3,71+3,71+3,68+3,61+3,61+3,61+3,68+3,19+3,CAM,235790,CAM|CF,84,91,84500000.0,130000.0,23,189,82,13.0,Left,4,4,3,Medium/Medium,Unique,False,False,False,False,False,False,False,False,False,False,False,False,False,False,False,False,False,False,False,False,False,False,False,False,False,False,False,False,False,False,False,False,False,False,False,False,False,False,False,False,False,False,False,False,81.0,79.0,79.0,84.0,45.0,66.0,74,81,80,84,80,85,84,53,79,85,76,85,77,84,75,74,75,77,69,78,42,38,82,82,73,84.0,39,46,38,6,8,11,10,12,,81+3,81+3,81+3,82,82,82,82,82,83+3,83+3,83+3,82+3,78+3,78+3,78+3,82+3,65+3,63+3,63+3,63+3,65+3,62+3,56+3,56+3,56+3,62+3,17+3,CAM,188567,CF|ST,85,85,34500000.0,180000.0,33,187,80,13.0,Right,4,4,3,High/Low,Unique,False,False,False,False,False,False,False,False,False,False,False,False,False,False,False,False,False,False,False,False,False,False,False,False,False,False,False,False,False,False,False,False,False,False,False,False,False,False,False,False,False,False,False,False,87.0,84.0,74.0,79.0,36.0,68.0,72,87,76,78,82,78,80,76,64,81,85,89,77,84,67,82,75,74,74,79,43,48,88,74,82,83.0,20,29,36,6,9,15,9,9,,83+2,83+2,83+2,81,82,82,82,81,80+3,80+3,80+3,80+3,73+3,73+3,73+3,80+3,62+3,58+3,58+3,58+3,62+3,59+3,51+3,51+3,51+3,59+3,17+3,ST
5,95.0,2022.0,4-3-1-2,to_be_implemented,207998,GK,75,75,3800000.0,49000.0,29,191,88,13.0,Right,3,1,1,Medium/Medium,Normal (185+),False,False,False,False,False,False,False,False,False,False,False,False,False,False,False,False,False,False,False,False,False,False,False,False,False,False,False,False,False,False,False,False,False,False,False,False,False,False,False,False,False,False,False,False,,,,,,,13,11,13,30,13,19,15,14,42,23,46,44,38,70,53,50,67,22,60,16,32,20,7,38,20,56.0,8,20,18,75,73,67,74,76,45.0,28+2,28+2,28+2,27,28,28,28,27,29+2,29+2,29+2,28+2,30+2,30+2,30+2,28+2,26+2,29+2,29+2,29+2,26+2,26+2,27+2,27+2,27+2,26+2,74+1,GK,210243,RB|RWB,83,83,33000000.0,105000.0,28,175,70,13.0,Right,4,3,3,High/High,Unique,False,False,False,False,False,False,False,False,False,False,False,False,False,False,False,False,False,False,False,False,False,False,False,False,False,False,False,False,False,False,False,False,False,False,False,False,False,False,False,False,False,False,False,False,79.0,67.0,79.0,81.0,80.0,73.0,82,66,68,82,59,81,78,52,77,83,83,76,76,82,79,74,75,76,69,64,79,79,77,77,61,81.0,81,84,83,16,12,15,11,11,,74+3,74+3,74+3,78,78,78,78,78,78+3,78+3,78+3,79+3,79+3,79+3,79+3,79+3,81+2,80+3,80+3,80+3,81+2,81+2,79+3,79+3,79+3,81+2,20+3,RB,169588,LCB|CB,79,79,5500000.0,76000.0,34,188,77,13.0,Right,4,2,2,Medium/High,Lean (185+),False,False,False,False,False,False,False,False,False,False,False,False,False,False,False,False,False,False,False,False,False,False,False,False,False,False,False,False,False,False,False,False,False,False,False,False,False,False,False,False,False,False,False,False,50.0,32.0,60.0,58.0,82.0,76.0,52,28,80,72,46,51,34,37,65,69,51,49,34,80,57,42,79,64,80,24,82,79,30,57,44,81.0,86,81,78,12,16,16,15,8,,52+2,52+2,52+2,52,52,52,52,52,55+2,55+2,55+2,56+2,63+2,63+2,63+2,56+2,69+2,75+2,75+2,75+2,69+2,71+2,79,79,79,71+2,20+2,CB,232119,RCB|CB,78,80,15500000.0,69000.0,26,185,82,13.0,Right,4,2,1,Medium/Medium,Normal (185+),False,False,False,False,False,False,False,False,False,False,False,False,False,False,False,False,False,False,False,False,False,False,False,False,False,False,False,False,False,False,False,False,False,False,False,False,False,False,False,False,False,False,False,False,71.0,46.0,60.0,65.0,78.0,79.0,46,39,75,76,48,62,39,39,64,69,65,75,64,77,55,65,76,65,82,44,89,78,42,55,52,76.0,76,80,78,6,7,7,7,7,,60+2,60+2,60+2,60,60,60,60,60,62+2,62+2,62+2,62+2,65+2,65+2,65+2,62+2,71+2,74+2,74+2,74+2,71+2,72+2,78+2,78+2,78+2,72+2,14+2,CB,231554,LB|LWB,76,79,9500000.0,52000.0,24,183,80,13.0,Right,4,3,1,High/High,Normal (170-185),False,False,False,False,False,False,False,False,False,False,False,False,False,False,False,False,False,False,False,False,False,False,False,False,False,False,False,False,False,False,False,False,False,False,False,False,False,False,False,False,False,False,False,False,81.0,50.0,69.0,72.0,73.0,70.0,73,53,65,72,42,73,60,60,65,74,77,85,67,74,70,54,64,77,68,40,66,70,66,67,43,66.0,73,77,75,13,7,6,5,14,,65+2,65+2,65+2,70,68,68,68,70,69+2,69+2,69+2,72+2,69+2,69+2,69+2,72+2,75+2,72+2,72+2,72+2,75+2,74+2,72+2,72+2,72+2,74+2,17+2,LB,216393,CDM|CM,84,86,52500000.0,115000.0,25,176,72,13.0,Right,5,4,2,Medium/Medium,Normal (170-185),False,False,False,False,False,False,False,False,False,False,False,False,False,False,False,False,False,False,False,False,False,False,False,False,False,False,False,False,False,False,False,False,False,False,False,False,False,False,False,False,False,False,False,False,56.0,80.0,86.0,81.0,70.0,73.0,82,74,67,89,79,81,84,78,88,85,58,54,67,84,77,87,68,85,69,87,69,71,80,87,77,85.0,69,73,68,6,8,10,14,12,,77+2,77+2,77+2,79,80,80,80,79,82+2,82+2,82+2,80+2,84+2,84+2,84+2,80+2,76+2,79+2,79+2,79+2,76+2,74+2,72+2,72+2,72+2,74+2,18+2,CM,226790,CDM|CM,84,86,47500000.0,105000.0,25,183,74,13.0,Right,4,3,1,Medium/High,Lean (170-185),False,False,False,False,False,False,False,False,False,False,False,False,False,False,False,False,False,False,False,False,False,False,False,False,False,False,False,False,False,False,False,False,False,False,False,False,False,False,False,False,False,False,False,False,66.0,62.0,68.0,73.0,85.0,83.0,53,50,70,78,68,72,60,60,75,77,64,68,63,87,66,80,89,89,78,69,88,88,64,62,57,80.0,86,88,84,13,14,7,7,13,,69+2,69+2,69+2,68,70,70,70,68,70+2,70+2,70+2,70+2,76+2,76+2,76+2,70+2,79+2,82+2,82+2,82+2,79+2,79+2,83+2,83+2,83+2,79+2,20+2,CDM,239817,CDM|CM,76,81,10500000.0,52000.0,23,188,82,13.0,Right,3,3,1,Medium/Medium,Lean (185+),False,False,False,False,False,False,False,False,False,False,False,False,False,False,False,False,False,False,False,False,False,False,False,False,False,False,False,False,False,False,False,False,False,False,False,False,False,False,False,False,False,False,False,False,68.0,56.0,73.0,74.0,70.0,80.0,65,51,60,78,53,75,65,53,77,78,66,69,62,76,69,64,70,79,84,58,76,73,68,77,52,77.0,71,72,69,11,6,13,5,10,,67+2,67+2,67+2,70,70,70,70,70,72+2,72+2,72+2,72+2,75+2,75+2,75+2,72+2,73+2,75+2,75+2,75+2,73+2,72+2,73+2,73+2,73+2,72+2,16+2,CDM,220697,CAM|CF,82,84,38000000.0,100000.0,25,175,73,13.0,Right,4,4,1,High/Medium,Lean (170-185),False,False,False,False,False,False,False,False,False,False,False,False,False,False,False,False,False,False,False,False,False,False,False,False,False,False,False,False,False,False,False,False,False,False,False,False,False,False,False,False,False,False,False,False,73.0,78.0,84.0,85.0,54.0,62.0,81,76,35,84,73,85,86,84,83,86,77,69,84,78,83,83,51,76,53,80,68,44,81,85,74,84.0,59,65,42,11,14,14,12,14,,74+2,74+2,74+2,81,80,80,80,81,82+2,82+2,82+2,81+2,80+2,80+2,80+2,81+2,69+2,69+2,69+2,69+2,69+2,65+2,57+2,57+2,57+2,65+2,20+2,CAM,208830,CF|ST,85,85,23000000.0,110000.0,35,179,74,13.0,Right,4,3,3,High/Medium,Unique,False,False,False,False,False,False,False,False,False,False,False,False,False,False,False,False,False,False,False,False,False,False,False,False,False,False,False,False,False,False,False,False,False,False,False,False,False,False,False,False,False,False,False,False,84.0,84.0,70.0,79.0,52.0,72.0,69,90,78,74,85,76,69,61,60,83,85,84,74,88,75,87,80,73,65,65,86,49,90,74,85,86.0,45,52,54,15,14,7,15,11,,83+2,83+2,83+2,80,82,82,82,80,79+3,79+3,79+3,79+3,73+3,73+3,73+3,79+3,67+3,65+3,65+3,65+3,67+3,66+3,63+3,63+3,63+3,66+3,22+3,ST,225719,CF|ST,77,79,13500000.0,74000.0,25,185,82,13.0,Left,3,4,1,Medium/Medium,Normal (185+),False,False,False,False,False,False,False,False,False,False,False,False,False,False,False,False,False,False,False,False,False,False,False,False,False,False,False,False,False,False,False,False,False,False,False,False,False,False,False,False,False,False,False,False,73.0,79.0,70.0,77.0,38.0,70.0,59,81,67,77,77,78,74,64,69,81,72,73,73,77,69,81,57,66,73,77,71,30,80,72,70,68.0,39,36,32,8,7,7,11,15,,77+2,77+2,77+2,76,78,78,78,76,77+2,77+2,77+2,74+2,71+2,71+2,71+2,74+2,57+2,58+2,58+2,58+2,57+2,54+2,52+2,52+2,52+2,54+2,17+2,ST
6,13.0,2022.0,3-5-2,to_be_implemented,203841,GK,81,81,17000000.0,75000.0,30,199,76,13.0,Right,3,1,1,Medium/Medium,Lean (185+),False,False,False,False,False,False,False,False,False,False,False,False,False,False,False,False,False,False,False,False,False,False,False,False,False,False,False,False,False,False,False,False,False,False,False,False,False,False,False,False,False,False,False,False,,,,,,,11,14,11,29,14,15,13,12,52,24,50,47,36,76,42,56,72,37,75,15,36,21,13,50,22,63.0,14,15,14,80,82,75,80,83,49.0,31+2,31+2,31+2,28,31,31,31,28,32+2,32+2,32+2,31+2,34+2,34+2,34+2,31+2,28+2,33+2,33+2,33+2,28+2,27+2,29+2,29+2,29+2,27+2,80+1,GK,251809,RCB|CB,80,86,31000000.0,74000.0,22,193,81,13.0,Left,3,2,2,Medium/High,Normal (185+),False,False,False,False,False,False,False,False,False,False,False,False,False,False,False,False,False,False,False,False,False,False,False,False,False,False,False,False,False,False,False,False,False,False,False,False,False,False,False,False,False,False,False,False,58.0,37.0,60.0,62.0,80.0,84.0,43,24,81,74,27,59,47,28,70,66,54,62,57,78,37,65,77,78,89,37,81,77,45,57,37,74.0,79,83,80,12,9,8,6,14,,57+2,57+2,57+2,55,57,57,57,55,59+2,59+2,59+2,59+2,66+2,66+2,66+2,59+2,70+2,76+2,76+2,76+2,70+2,72+2,80+2,80+2,80+2,72+2,18+2,CB,198032,CB,77,77,8500000.0,69000.0,30,198,87,13.0,Left,3,2,1,Medium/High,Lean (185+),False,False,False,False,False,False,False,False,False,False,False,False,False,False,False,False,False,False,False,False,False,False,False,False,False,False,False,False,False,False,False,False,False,False,False,False,False,False,False,False,False,False,False,False,47.0,33.0,65.0,63.0,77.0,80.0,67,25,78,74,22,69,48,46,67,67,37,55,33,75,30,53,50,67,89,29,83,76,37,53,48,74.0,78,78,75,15,13,7,8,10,,54+2,54+2,54+2,55,55,55,55,55,57+2,57+2,57+2,60+2,64+2,64+2,64+2,60+2,70+2,74+2,74+2,74+2,70+2,71+2,77,77,77,71+2,18+2,CB,210047,LCB|CB,77,77,8500000.0,69000.0,30,188,84,13.0,Right,3,2,2,High/Medium,Normal (185+),False,False,False,False,False,False,False,False,False,False,False,False,False,False,False,False,False,False,False,False,False,False,False,False,False,False,False,False,False,False,False,False,False,False,False,False,False,False,False,False,False,False,False,False,51.0,67.0,70.0,67.0,78.0,74.0,65,60,80,74,61,66,66,66,74,72,50,52,53,77,61,77,77,64,78,73,74,79,62,67,75,77.0,77,79,75,8,9,11,10,15,,68+2,68+2,68+2,65,67,67,67,65,68+2,68+2,68+2,66+2,71+2,71+2,71+2,66+2,71+2,75+2,75+2,75+2,71+2,72+2,77,77,77,72+2,18+2,CB,186345,RM|RWB|RB,84,84,30500000.0,120000.0,31,173,71,13.0,Right,4,3,2,Medium/Medium,Normal (170-185),False,False,False,False,False,False,False,False,False,False,False,False,False,False,False,False,False,False,False,False,False,False,False,False,False,False,False,False,False,False,False,False,False,False,False,False,False,False,False,False,False,False,False,False,70.0,64.0,82.0,77.0,80.0,72.0,86,54,79,82,58,74,86,84,80,82,74,66,66,83,79,79,78,86,64,70,73,81,76,80,66,78.0,79,81,81,11,14,8,11,10,,72+2,72+2,72+2,75,75,75,75,75,76+2,76+2,76+2,78+2,80+2,80+2,80+2,78+2,81+2,80+2,80+2,80+2,81+2,81+2,78+2,78+2,78+2,81+2,19+2,RB,247851,CDM|CM,81,86,38500000.0,88000.0,24,182,74,13.0,Right,2,3,2,High/High,Normal (170-185),False,False,False,False,False,False,False,False,False,False,False,False,False,False,False,False,False,False,False,False,False,False,False,False,False,False,False,False,False,False,False,False,False,False,False,False,False,False,False,False,False,False,False,False,69.0,67.0,79.0,81.0,76.0,77.0,68,68,61,84,66,81,75,62,83,82,68,69,74,80,78,64,62,84,75,67,77,78,72,82,65,83.0,77,79,74,7,11,15,11,11,,72+2,72+2,72+2,76,76,76,76,76,78+2,78+2,78+2,77+2,81+2,81+2,81+2,77+2,77+2,80+2,80+2,80+2,77+2,76+2,75+2,75+2,75+2,76+2,18+2,CM,189165,CDM|CM,77,77,10000000.0,76000.0,30,184,80,13.0,Right,3,3,2,Medium/Medium,Normal (170-185),False,False,False,False,False,False,False,False,False,False,False,False,False,False,False,False,False,False,False,False,False,False,False,False,False,False,False,False,False,False,False,False,False,False,False,False,False,False,False,False,False,False,False,False,40.0,71.0,80.0,72.0,62.0,74.0,75,62,67,83,66,73,69,73,85,77,43,38,55,73,63,85,62,75,71,79,83,62,65,82,71,80.0,60,63,60,14,11,15,8,16,,68+2,68+2,68+2,69,70,70,70,69,73+2,73+2,73+2,71+2,77,77,77,71+2,67+2,72+2,72+2,72+2,67+2,65+2,66+2,66+2,66+2,65+2,19+2,CM,223334,CDM|CM,75,78,7500000.0,64000.0,25,186,81,13.0,Right,3,3,1,High/High,Stocky (185+),False,False,False,False,False,False,False,False,False,False,False,False,False,False,False,False,False,False,False,False,False,False,False,False,False,False,False,False,False,False,False,False,False,False,False,False,False,False,False,False,False,False,False,False,76.0,67.0,66.0,76.0,67.0,84.0,41,65,78,78,59,80,52,38,70,76,74,77,66,77,68,81,79,86,84,60,83,65,74,77,61,74.0,63,70,61,9,13,8,13,13,,74+2,74+2,74+2,72,75,75,75,72,75+2,75+2,75+2,73+2,75+2,75+2,75+2,73+2,69+2,73+2,73+2,73+2,69+2,69+2,72+2,72+2,72+2,69+2,19+2,CM,216388,LM|LWB|LB,81,83,32500000.0,95000.0,25,173,67,13.0,Right,4,5,2,High/Low,Stocky (170-185),False,False,False,False,False,False,False,False,False,False,False,False,False,False,False,False,False,False,False,False,False,False,False,False,False,False,False,False,False,False,False,False,False,False,False,False,False,False,False,False,False,False,False,False,90.0,73.0,73.0,88.0,27.0,68.0,73,72,53,76,63,92,76,58,64,83,91,90,93,78,89,82,73,77,73,70,43,20,76,75,58,83.0,29,21,23,10,9,12,7,7,,76+2,76+2,76+2,81,80,80,80,81,80+2,80+2,80+2,80+2,71+2,71+2,71+2,80+2,58+2,53+2,53+2,53+2,58+2,53+2,43+2,43+2,43+2,53+2,16+2,LM,233731,CF|ST,80,85,33000000.0,90000.0,22,192,77,13.0,Right,5,4,2,High/Low,Unique,False,False,False,False,False,False,False,False,False,False,False,False,False,False,False,False,False,False,False,False,False,False,False,False,False,False,False,False,False,False,False,False,False,False,False,False,False,False,False,False,False,False,False,False,83.0,79.0,68.0,83.0,29.0,68.0,61,79,74,75,79,85,70,65,52,86,80,85,79,79,66,81,71,68,75,76,52,29,83,76,75,77.0,25,21,18,7,6,9,7,11,,80+2,80+2,80+2,79,81,81,81,79,79+2,79+2,79+2,77+2,70+2,70+2,70+2,77+2,55+2,52+2,52+2,52+2,55+2,52+2,46+2,46+2,46+2,52+2,16+2,ST,196978,CF|ST,79,79,17000000.0,95000.0,30,180,66,13.0,Right,3,4,2,High/Medium,Normal (170-185),False,False,False,False,False,False,False,False,False,False,False,False,False,False,False,False,False,False,False,False,False,False,False,False,False,False,False,False,False,False,False,False,False,False,False,False,False,False,False,False,False,False,False,False,81.0,78.0,66.0,77.0,42.0,76.0,61,83,78,72,71,77,63,45,62,79,78,83,73,80,72,78,70,69,80,68,74,40,84,70,83,79.0,38,40,27,10,15,8,10,6,,79,79,79,76,78,78,78,76,76+2,76+2,76+2,75+2,70+2,70+2,70+2,75+2,59+2,59+2,59+2,59+2,59+2,57+2,56+2,56+2,56+2,57+2,18+2,ST
7,2.0,2022.0,4-3-1-2,to_be_implemented,202811,GK,84,84,29000000.0,95000.0,29,195,88,13.0,Right,4,1,3,Medium/Medium,Stocky (185+),False,False,False,False,False,False,False,False,False,False,False,False,False,False,False,False,False,False,False,False,False,False,False,False,False,False,False,False,False,False,False,False,False,False,False,False,False,False,False,False,False,False,False,False,,,,,,,22,16,26,50,13,13,22,20,59,35,59,57,49,80,49,62,60,40,70,16,37,13,12,66,42,60.0,11,20,20,85,83,82,83,85,58.0,36+3,36+3,36+3,35,37,37,37,35,41+3,41+3,41+3,39+3,43+3,43+3,43+3,39+3,33+3,38+3,38+3,38+3,33+3,33+3,32+3,32+3,32+3,33+3,83+1,GK,227174,RB|RWB,79,84,24500000.0,65000.0,24,185,74,13.0,Right,2,3,2,High/Medium,Normal (185+),False,False,False,False,False,False,False,False,False,False,False,False,False,False,False,False,False,False,False,False,False,False,False,False,False,False,False,False,False,False,False,False,False,False,False,False,False,False,False,False,False,False,False,False,80.0,67.0,71.0,75.0,74.0,76.0,77,67,49,73,48,75,66,48,71,74,79,81,78,78,74,77,77,87,68,64,82,76,71,67,44,72.0,77,77,78,15,16,13,13,8,,70+2,70+2,70+2,74,73,73,73,74,72+2,72+2,72+2,75+2,73+2,73+2,73+2,75+2,78+2,76+2,76+2,76+2,78+2,77+2,73+2,73+2,73+2,77+2,20+2,RB,219693,LCB|CB,83,83,30500000.0,105000.0,29,186,79,13.0,Right,4,3,2,Medium/High,Stocky (185+),False,False,False,False,False,False,False,False,False,False,False,False,False,False,False,False,False,False,False,False,False,False,False,False,False,False,False,False,False,False,False,False,False,False,False,False,False,False,False,False,False,False,False,False,76.0,47.0,63.0,67.0,82.0,82.0,35,32,79,76,34,65,47,71,74,71,77,76,62,84,50,73,82,68,87,57,85,83,52,63,41,75.0,84,80,81,7,10,14,7,11,,64+2,64+2,64+2,62,65,65,65,62,66+2,66+2,66+2,64+2,70+2,70+2,70+2,64+2,72+2,78+2,78+2,78+2,72+2,75+2,82+1,82+1,82+1,75+2,17+2,CB,227678,RCB|CB,79,86,32500000.0,65000.0,24,183,77,13.0,Right,3,2,2,Medium/Medium,Lean (170-185),False,False,False,False,False,False,False,False,False,False,False,False,False,False,False,False,False,False,False,False,False,False,False,False,False,False,False,False,False,False,False,False,False,False,False,False,False,False,False,False,False,False,False,False,78.0,39.0,62.0,71.0,80.0,76.0,51,34,78,74,35,70,37,38,72,74,72,82,63,80,69,58,78,72,78,32,75,79,50,58,38,79.0,83,80,79,14,8,11,13,9,,61+2,61+2,61+2,63,63,63,63,63,64+2,64+2,64+2,66+2,68+2,68+2,68+2,66+2,74+2,76+2,76+2,76+2,74+2,76+2,79+2,79+2,79+2,76+2,19+2,CB,200458,LB|LWB,82,82,27500000.0,100000.0,28,178,74,13.0,Left,2,3,2,High/Medium,Unique,False,False,False,False,False,False,False,False,False,False,False,False,False,False,False,False,False,False,False,False,False,False,False,False,False,False,False,False,False,False,False,False,False,False,False,False,False,False,False,False,False,False,False,False,78.0,69.0,80.0,79.0,77.0,76.0,88,60,72,81,68,78,83,83,73,82,80,76,74,81,78,83,92,85,69,76,76,80,73,75,60,81.0,76,78,80,6,12,9,6,13,,74+2,74+2,74+2,77,76,76,76,77,77+2,77+2,77+2,78+2,78+2,78+2,78+2,78+2,81+1,79+2,79+2,79+2,81+1,80+2,77+2,77+2,77+2,80+2,17+2,LB,236987,CDM|CM,80,86,31000000.0,69000.0,22,184,68,13.0,Right,3,3,2,Medium/High,Lean (170-185),False,False,False,False,False,False,False,False,False,False,False,False,False,False,False,False,False,False,False,False,False,False,False,False,False,False,False,False,False,False,False,False,False,False,False,False,False,False,False,False,False,False,False,False,70.0,54.0,71.0,73.0,80.0,79.0,64,47,72,77,28,71,59,47,75,77,71,70,68,74,66,67,79,82,76,63,84,86,52,72,63,84.0,78,82,80,8,12,8,6,11,,64+2,64+2,64+2,67,67,67,67,67,69+2,69+2,69+2,70+2,74+2,74+2,74+2,70+2,77+2,79+2,79+2,79+2,77+2,77+2,79+2,79+2,79+2,77+2,16+2,CDM,210881,CDM|CM,79,80,20000000.0,83000.0,27,178,68,13.0,Left,2,3,2,High/High,Normal (170-185),False,False,False,False,False,False,False,False,False,False,False,False,False,False,False,False,False,False,False,False,False,False,False,False,False,False,False,False,False,False,False,False,False,False,False,False,False,False,False,False,False,False,False,False,69.0,74.0,76.0,77.0,73.0,81.0,69,71,59,79,75,78,66,61,86,78,73,65,77,76,80,83,75,90,78,76,79,73,72,76,55,68.0,72,78,71,9,13,12,10,12,,73+2,73+2,73+2,75,75,75,75,75,76+2,76+2,76+2,76+2,79+1,79+1,79+1,76+2,75+2,78+2,78+2,78+2,75+2,74+2,74+2,74+2,74+2,74+2,18+2,CM,236499,CDM|CM,78,83,19500000.0,59000.0,24,175,66,13.0,Right,2,3,2,High/Medium,Normal (170-185),False,False,False,False,False,False,False,False,False,False,False,False,False,False,False,False,False,False,False,False,False,False,False,False,False,False,False,False,False,False,False,False,False,False,False,False,False,False,False,False,False,False,False,False,67.0,68.0,77.0,77.0,73.0,70.0,69,64,62,82,58,75,80,63,80,82,69,65,74,77,74,80,66,76,66,76,74,77,58,77,44,81.0,75,75,68,12,6,13,10,7,,70+2,70+2,70+2,73,73,73,73,73,75+2,75+2,75+2,74+2,77+2,77+2,77+2,74+2,74+2,77+2,77+2,77+2,74+2,73+2,73+2,73+2,73+2,73+2,16+2,CDM,189242,CAM|CF,82,82,29500000.0,100000.0,30,172,68,13.0,Right,4,5,4,High/Medium,Normal (170-185),False,False,False,False,False,False,False,False,False,False,False,False,False,False,False,False,False,False,False,False,False,False,False,False,False,False,False,False,False,False,False,False,False,False,False,False,False,False,False,False,False,False,False,False,62.0,79.0,80.0,88.0,52.0,59.0,78,75,48,80,78,89,90,86,77,89,74,53,91,80,92,82,58,74,52,86,59,49,80,82,70,79.0,55,54,47,12,7,9,14,6,,75+3,75+3,75+3,81,80,80,80,81,82,82,82,80+2,79+3,79+3,79+3,80+2,67+3,67+3,67+3,67+3,67+3,63+3,56+3,56+3,56+3,63+3,17+3,CAM,195859,CF|ST,79,79,17500000.0,95000.0,29,178,73,13.0,Right,3,3,1,High/Medium,Normal (170-185),False,False,False,False,False,False,False,False,False,False,False,False,False,False,False,False,False,False,False,False,False,False,False,False,False,False,False,False,False,False,False,False,False,False,False,False,False,False,False,False,False,False,False,False,72.0,82.0,70.0,78.0,45.0,70.0,66,82,78,75,76,77,72,70,61,79,75,69,76,82,77,82,77,73,69,82,67,46,83,72,81,82.0,38,45,34,10,13,12,16,6,,79,79,79,77,78,78,78,77,77+2,77+2,77+2,75+2,72+2,72+2,72+2,75+2,61+2,61+2,61+2,61+2,61+2,59+2,56+2,56+2,56+2,59+2,19+2,ST,221697,CF|ST,78,81,18500000.0,82000.0,26,180,70,13.0,Right,4,3,2,High/High,Normal (170-185),False,False,False,False,False,False,False,False,False,False,False,False,False,False,False,False,False,False,False,False,False,False,False,False,False,False,False,False,False,False,False,False,False,False,False,False,False,False,False,False,False,False,False,False,84.0,76.0,68.0,74.0,46.0,77.0,67,81,81,72,64,75,63,56,59,73,77,89,79,77,73,75,92,88,79,71,52,44,79,74,67,66.0,40,46,36,14,14,14,6,10,,78+2,78+2,78+2,76,76,76,76,76,75+2,75+2,75+2,75+2,70+2,70+2,70+2,75+2,63+2,60+2,60+2,60+2,63+2,61+2,57+2,57+2,57+2,61+2,18+2,ST
8,1.0,2022.0,4-3-2-1,to_be_implemented,233934,GK,82,86,34500000.0,62000.0,24,191,77,13.0,Right,3,1,1,Medium/Medium,Lean (185+),False,False,False,False,False,False,False,False,False,False,False,False,False,False,False,False,False,False,False,False,False,False,False,False,False,False,False,False,False,False,False,False,False,False,False,False,False,False,False,False,False,False,False,False,,,,,,,15,14,15,54,16,18,17,16,54,35,47,50,53,80,49,64,66,35,59,15,35,24,18,64,25,65.0,20,16,15,83,77,85,78,84,48.0,35+2,35+2,35+2,35,38,38,38,35,41+2,41+2,41+2,38+2,43+2,43+2,43+2,38+2,33+2,39+2,39+2,39+2,33+2,32+2,31+2,31+2,31+2,32+2,81+2,GK,232938,RB|RWB,79,85,26000000.0,65000.0,23,188,84,13.0,Right,5,2,1,Medium/High,Lean (185+),False,False,False,False,False,False,False,False,False,False,False,False,False,False,False,False,False,False,False,False,False,False,False,False,False,False,False,False,False,False,False,False,False,False,False,False,False,False,False,False,False,False,False,False,74.0,33.0,67.0,71.0,80.0,79.0,65,29,74,75,30,69,48,37,70,75,76,72,69,78,70,42,70,80,80,28,78,78,58,63,37,72.0,81,82,79,9,14,6,5,11,,59+2,59+2,59+2,64,63,63,63,64,65+2,65+2,65+2,68+2,70+2,70+2,70+2,68+2,76+2,77+2,77+2,77+2,76+2,77+2,78+2,78+2,78+2,77+2,17+2,RB,232580,LCB|CB,81,87,37000000.0,74000.0,24,190,87,13.0,Left,2,2,2,Medium/High,Normal (185+),False,False,False,False,False,False,False,False,False,False,False,False,False,False,False,False,False,False,False,False,False,False,False,False,False,False,False,False,False,False,False,False,False,False,False,False,False,False,False,False,False,False,False,False,68.0,36.0,60.0,58.0,83.0,80.0,38,31,85,75,28,52,47,27,72,65,61,73,51,81,37,51,70,66,87,30,81,80,44,59,40,74.0,83,84,80,12,8,13,10,7,,57+2,57+2,57+2,55,57,57,57,55,59+2,59+2,59+2,59+2,66+2,66+2,66+2,59+2,70+2,76+2,76+2,76+2,70+2,73+2,81+2,81+2,81+2,73+2,17+2,CB,243715,RCB|CB,80,87,40000000.0,58000.0,21,192,85,13.0,Right,3,2,2,Medium/High,Normal (185+),False,False,False,False,False,False,False,False,False,False,False,False,False,False,False,False,False,False,False,False,False,False,False,False,False,False,False,False,False,False,False,False,False,False,False,False,False,False,False,False,False,False,False,False,78.0,39.0,67.0,71.0,80.0,79.0,58,37,67,78,34,70,55,35,73,78,76,79,50,79,57,60,71,69,83,23,82,83,43,62,47,76.0,80,84,79,7,10,6,8,11,,60+2,60+2,60+2,64,63,63,63,64,65+2,65+2,65+2,68+2,70+2,70+2,70+2,68+2,76+2,78+2,78+2,78+2,76+2,77+2,80+2,80+2,80+2,77+2,17+2,CB,226491,LB|LWB,81,85,33000000.0,82000.0,25,178,70,13.0,Left,3,3,2,High/High,Normal (170-185),False,False,False,False,False,False,False,False,False,False,False,False,False,False,False,False,False,False,False,False,False,False,False,False,False,False,False,False,False,False,False,False,False,False,False,False,False,False,False,False,False,False,False,False,84.0,60.0,75.0,78.0,76.0,79.0,83,52,59,78,38,79,72,56,68,77,86,83,76,79,77,79,81,86,74,66,84,77,75,74,42,75.0,78,78,77,13,16,8,12,13,,70+2,70+2,70+2,76,74,74,74,76,75+2,75+2,75+2,77+2,75+2,75+2,75+2,77+2,80+2,77+2,77+2,77+2,80+2,79+2,76+2,76+2,76+2,79+2,20+2,LB,209989,CDM|CM,84,84,36000000.0,115000.0,29,185,77,13.0,Right,3,3,2,Medium/High,Lean (185+),False,False,False,False,False,False,False,False,False,False,False,False,False,False,False,False,False,False,False,False,False,False,False,False,False,False,False,False,False,False,False,False,False,False,False,False,False,False,False,False,False,False,False,False,65.0,71.0,81.0,80.0,80.0,83.0,74,66,68,85,56,84,69,70,85,83,61,68,67,82,50,86,83,82,84,78,84,81,70,85,49,86.0,80,84,80,11,13,9,9,7,,75+2,75+2,75+2,77,78,78,78,77,79+2,79+2,79+2,78+2,82+2,82+2,82+2,78+2,80+2,83+1,83+1,83+1,80+2,79+2,81+2,81+2,81+2,79+2,18+2,CDM,199503,CDM|CM,79,79,15000000.0,80000.0,29,185,82,13.0,Left,2,3,3,Low/Medium,Normal (185+),False,False,False,False,False,False,False,False,False,False,False,False,False,False,False,False,False,False,False,False,False,False,False,False,False,False,False,False,False,False,False,False,False,False,False,False,False,False,False,False,False,False,False,False,49.0,64.0,79.0,69.0,69.0,80.0,71,50,62,84,50,66,76,77,84,80,48,50,49,73,61,90,33,82,79,75,91,71,62,77,63,67.0,71,68,68,7,8,11,7,13,,67+3,67+3,67+3,67,69,69,69,67,71+3,71+3,71+3,70+3,76+3,76+3,76+3,70+3,71+3,77+2,77+2,77+2,71+3,70+3,71+3,71+3,71+3,70+3,16+3,CDM,211454,CDM|CM,76,76,6500000.0,63000.0,29,179,72,13.0,Right,3,3,1,Medium/High,Lean (170-185),False,False,False,False,False,False,False,False,False,False,False,False,False,False,False,False,False,False,False,False,False,False,False,False,False,False,False,False,False,False,False,False,False,False,False,False,False,False,False,False,False,False,False,False,56.0,63.0,71.0,70.0,73.0,73.0,64,57,61,77,39,68,69,56,76,75,57,55,65,74,62,78,69,83,68,69,73,75,63,69,62,75.0,74,74,72,7,15,15,12,6,,66+2,66+2,66+2,67,68,68,68,67,69+2,69+2,69+2,69+2,73+2,73+2,73+2,69+2,72+2,75+1,75+1,75+1,72+2,71+2,72+2,72+2,72+2,71+2,17+2,CDM,222665,CAM|CF,84,89,63500000.0,105000.0,23,178,68,13.0,Left,2,5,3,High/Medium,Lean (170-185),False,False,False,False,False,False,False,False,False,False,False,False,False,False,False,False,False,False,False,False,False,False,False,False,False,False,False,False,False,False,False,False,False,False,False,False,False,False,False,False,False,False,False,False,76.0,75.0,86.0,84.0,58.0,63.0,84,75,52,88,76,85,83,85,84,85,78,75,85,74,83,76,46,79,56,77,63,65,79,86,63,78.0,65,49,51,14,15,15,8,10,,75+3,75+3,75+3,82,80,80,80,82,83+3,83+3,83+3,82+3,81+3,81+3,81+3,82+3,72+3,71+3,71+3,71+3,72+3,69+3,61+3,61+3,61+3,69+3,19+3,CAM,256958,CAM|CF,77,87,23500000.0,62000.0,22,176,61,13.0,Left,3,3,1,High/Medium,Lean (170-185),False,False,False,False,False,False,False,False,False,False,False,False,False,False,False,False,False,False,False,False,False,False,False,False,False,False,False,False,False,False,False,False,False,False,False,False,False,False,False,False,False,False,False,False,75.0,71.0,77.0,77.0,40.0,52.0,73,69,46,79,65,78,74,68,76,80,76,74,76,71,69,73,47,62,48,74,51,33,73,82,69,75.0,41,42,35,9,5,15,13,6,,70+2,70+2,70+2,76,75,75,75,76,77+2,77+2,77+2,75+2,73+2,73+2,73+2,75+2,60+2,58+2,58+2,58+2,60+2,56+2,47+2,47+2,47+2,56+2,15+2,CAM,230666,CF|ST,83,86,48500000.0,115000.0,25,175,73,13.0,Right,3,4,2,High/High,Unique,False,False,False,False,False,False,False,False,False,False,False,False,False,False,False,False,False,False,False,False,False,False,False,False,False,False,False,False,False,False,False,False,False,False,False,False,False,False,False,False,False,False,False,False,84.0,82.0,74.0,86.0,40.0,74.0,74,83,78,78,78,87,76,54,66,85,87,82,91,85,87,84,79,82,69,77,75,32,86,77,75,78.0,45,30,28,13,8,6,6,15,,83+2,83+2,83+2,83,83,83,83,83,82+2,82+2,82+2,82+2,75+2,75+2,75+2,82+2,63+2,60+2,60+2,60+2,63+2,59+2,54+2,54+2,54+2,59+2,18+2,ST
9,19.0,2022.0,4-3-2-1,to_be_implemented,164835,GK,82,82,3400000.0,43000.0,37,190,83,13.0,Right,2,1,2,Medium/Medium,Normal (185+),False,False,False,False,False,False,False,False,False,False,False,False,False,False,False,False,False,False,False,False,False,False,False,False,False,False,False,False,False,False,False,False,False,False,False,False,False,False,False,False,False,False,False,False,,,,,,,14,13,11,20,17,14,18,12,32,22,50,47,53,74,44,53,69,25,65,20,43,16,15,52,22,63.0,14,12,13,82,82,71,83,82,49.0,29+2,29+2,29+2,28,30,30,30,28,30+2,30+2,30+2,29+2,29+2,29+2,29+2,29+2,25+2,27+2,27+2,27+2,25+2,25+2,27+2,27+2,27+2,25+2,81+1,GK,244470,RB|RWB,80,80,18500000.0,73000.0,29,175,76,13.0,Right,3,3,1,High/High,Normal (170-185),False,False,False,False,False,False,False,False,False,False,False,False,False,False,False,False,False,False,False,False,False,False,False,False,False,False,False,False,False,False,False,False,False,False,False,False,False,False,False,False,False,False,False,False,73.0,56.0,73.0,75.0,78.0,81.0,81,50,70,75,61,73,75,42,73,76,74,73,74,78,84,66,85,85,76,59,86,76,69,69,49,72.0,78,81,78,13,12,12,6,13,,68+2,68+2,68+2,71,70,70,70,71,71+2,71+2,71+2,73+2,74+2,74+2,74+2,73+2,78+2,77+2,77+2,77+2,78+2,78+2,78+2,78+2,78+2,78+2,18+2,RB,204311,LCB|CB,80,82,22500000.0,70000.0,27,190,95,13.0,Right,3,2,2,Medium/Medium,Normal (185+),False,False,False,False,False,False,False,False,False,False,False,False,False,False,False,False,False,False,False,False,False,False,False,False,False,False,False,False,False,False,False,False,False,False,False,False,False,False,False,False,False,False,False,False,62.0,51.0,62.0,56.0,80.0,84.0,49,47,84,68,47,50,60,59,67,62,52,70,52,78,52,63,91,65,92,49,84,79,49,60,59,73.0,80,81,78,14,14,7,9,15,,61+2,61+2,61+2,57,59,59,59,57,59+2,59+2,59+2,59+2,64+2,64+2,64+2,59+2,69+2,74+2,74+2,74+2,69+2,72+2,80+2,80+2,80+2,72+2,20+2,CB,244749,RCB|CB,80,83,24500000.0,70000.0,26,188,76,13.0,Left,3,2,2,Medium/Medium,Normal (185+),False,False,False,False,False,False,False,False,False,False,False,False,False,False,False,False,False,False,False,False,False,False,False,False,False,False,False,False,False,False,False,False,False,False,False,False,False,False,False,False,False,False,False,False,73.0,50.0,64.0,65.0,80.0,77.0,48,40,81,76,41,58,55,41,72,75,65,80,58,80,56,69,89,76,76,54,77,81,52,60,48,73.0,78,83,78,7,15,9,14,6,,64+2,64+2,64+2,62,64,64,64,62,65+2,65+2,65+2,65+2,70+2,70+2,70+2,65+2,73+2,77+2,77+2,77+2,73+2,75+2,80+2,80+2,80+2,75+2,18+2,CB,189615,LB|LWB,78,78,9500000.0,60000.0,32,175,66,13.0,Left,3,3,2,High/Medium,Normal (170-185),False,False,False,False,False,False,False,False,False,False,False,False,False,False,False,False,False,False,False,False,False,False,False,False,False,False,False,False,False,False,False,False,False,False,False,False,False,False,False,False,False,False,False,False,64.0,60.0,75.0,75.0,77.0,68.0,83,54,68,77,48,76,80,76,69,77,68,61,67,78,76,71,86,73,61,66,73,77,60,68,59,73.0,78,78,79,14,7,9,9,12,,66+2,66+2,66+2,71,69,69,69,71,71+2,71+2,71+2,72+2,73+2,73+2,73+2,72+2,76+2,75+2,75+2,75+2,76+2,76+2,75+2,75+2,75+2,76+2,18+2,LB,234378,CDM|CM,84,87,52000000.0,83000.0,23,185,80,13.0,Right,3,2,1,Medium/High,Normal (185+),False,False,False,False,False,False,False,False,False,False,False,False,False,False,False,False,False,False,False,False,False,False,False,False,False,False,False,False,False,False,False,False,False,False,False,False,False,False,False,False,False,False,False,False,71.0,64.0,74.0,76.0,82.0,83.0,55,61,72,83,50,78,58,58,84,79,68,74,55,81,67,74,74,90,79,65,84,85,58,79,71,83.0,82,84,80,8,11,14,5,9,,70+2,70+2,70+2,71,73,73,73,71,75+2,75+2,75+2,74+2,79+2,79+2,79+2,74+2,78+2,83+2,83+2,83+2,78+2,79+2,81+2,81+2,81+2,79+2,17+2,CDM,236792,CDM|CM,81,83,28000000.0,75000.0,27,192,86,13.0,Right,3,3,1,High/High,Lean (185+),False,False,False,False,False,False,False,False,False,False,False,False,False,False,False,False,False,False,False,False,False,False,False,False,False,False,False,False,False,False,False,False,False,False,False,False,False,False,False,False,False,False,False,False,57.0,72.0,73.0,72.0,82.0,85.0,69,73,83,79,59,74,63,53,76,77,51,62,52,81,54,73,88,91,84,70,78,83,76,72,70,78.0,81,82,79,11,13,5,6,8,,75+2,75+2,75+2,72,74,74,74,72,74+2,74+2,74+2,74+2,78+2,78+2,78+2,74+2,78+2,80+2,80+2,80+2,78+2,78+2,81+2,81+2,81+2,78+2,17+2,CDM,240097,CDM|CM,70,76,2300000.0,25000.0,23,177,70,13.0,Right,3,2,1,Medium/High,Lean (170-185),False,False,False,False,False,False,False,False,False,False,False,False,False,False,False,False,False,False,False,False,False,False,False,False,False,False,False,False,False,False,False,False,False,False,False,False,False,False,False,False,False,False,False,False,66.0,53.0,67.0,68.0,66.0,72.0,61,52,58,73,32,67,49,55,70,68,67,66,75,64,77,59,65,77,69,55,76,65,56,69,48,67.0,68,68,67,13,12,14,11,6,,60+2,60+2,60+2,64,63,63,63,64,66+2,66+2,66+2,66+2,68+2,68+2,68+2,66+2,68+2,69+2,69+2,69+2,68+2,67+2,67+2,67+2,67+2,67+2,17+2,CDM,233927,CAM|CF,82,87,46000000.0,77000.0,24,180,72,13.0,Left,4,5,2,High/High,Normal (170-185),False,False,False,False,False,False,False,False,False,False,False,False,False,False,False,False,False,False,False,False,False,False,False,False,False,False,False,False,False,False,False,False,False,False,False,False,False,False,False,False,False,False,False,False,72.0,78.0,79.0,85.0,69.0,78.0,72,79,68,82,74,88,77,74,78,86,71,73,75,81,77,77,78,81,77,77,76,71,80,82,75,88.0,67,72,63,14,9,12,11,11,,79+2,79+2,79+2,80,81,81,81,80,82+2,82+2,82+2,80+2,81+2,81+2,81+2,80+2,75+2,76+2,76+2,76+2,75+2,73+2,72+2,72+2,72+2,73+2,19+2,CAM,188988,CAM|CF,79,79,17000000.0,75000.0,29,167,59,13.0,Right,3,4,2,Medium/Medium,Normal (170-),False,False,False,False,False,False,False,False,False,False,False,False,False,False,False,False,False,False,False,False,False,False,False,False,False,False,False,False,False,False,False,False,False,False,False,False,False,False,False,False,False,False,False,False,69.0,73.0,79.0,82.0,41.0,55.0,75,70,52,82,65,82,76,76,78,84,76,64,81,74,89,76,76,71,43,76,62,30,73,80,77,80.0,30,52,54,14,9,6,7,15,,71+2,71+2,71+2,77,77,77,77,77,79,79,79,77+2,75+2,75+2,75+2,77+2,63+2,61+2,61+2,61+2,63+2,60+2,51+2,51+2,51+2,60+2,18+2,CAM,226710,CF|ST,80,86,33500000.0,73000.0,23,195,85,13.0,Right,3,4,2,Medium/Medium,Normal (185+),False,False,False,False,False,False,False,False,False,False,False,False,False,False,False,False,False,False,False,False,False,False,False,False,False,False,False,False,False,False,False,False,False,False,False,False,False,False,False,False,False,False,False,False,73.0,80.0,66.0,74.0,36.0,74.0,44,83,82,76,79,73,69,68,67,80,70,75,63,78,68,80,84,65,85,74,55,26,82,70,68,78.0,40,28,20,12,10,11,7,12,,80+2,80+2,80+2,73,77,77,77,73,75+2,75+2,75+2,72+2,69+2,69+2,69+2,72+2,53+2,55+2,55+2,55+2,53+2,51+2,51+2,51+2,51+2,51+2,18+2,ST
10,110.0,2022.0,3-5-2,to_be_implemented,212442,GK,81,82,20000000.0,74000.0,29,192,84,13.0,Right,2,1,1,Medium/Medium,Normal (185+),False,False,False,False,False,False,False,False,False,False,False,False,False,False,False,False,False,False,False,False,False,False,False,False,False,False,False,False,False,False,False,False,False,False,False,False,False,False,False,False,False,False,False,False,,,,,,,18,15,14,48,17,17,12,21,42,19,52,53,62,80,40,55,70,34,75,18,35,18,17,50,11,45.0,14,19,15,83,78,73,79,83,52.0,33+2,33+2,33+2,32,34,34,34,32,36+2,36+2,36+2,34+2,36+2,36+2,36+2,34+2,31+2,34+2,34+2,34+2,31+2,30+2,31+2,31+2,31+2,30+2,80+2,GK,245336,RCB|CB,77,83,14500000.0,62000.0,25,194,89,13.0,Left,4,2,1,Medium/High,Normal (185+),False,False,False,False,False,False,False,False,False,False,False,False,False,False,False,False,False,False,False,False,False,False,False,False,False,False,False,False,False,False,False,False,False,False,False,False,False,False,False,False,False,False,False,False,61.0,42.0,63.0,63.0,78.0,78.0,54,36,68,71,36,62,45,39,70,66,53,68,54,78,51,51,68,68,85,43,73,78,47,61,48,70.0,79,80,79,11,11,5,9,12,,57+2,57+2,57+2,58,59,59,59,58,61+2,61+2,61+2,61+2,66+2,66+2,66+2,61+2,71+2,74+2,74+2,74+2,71+2,72+2,77+2,77+2,77+2,72+2,18+2,CB,248484,CB,75,82,10500000.0,41000.0,21,193,81,13.0,Right,3,2,1,Medium/High,Normal (185+),False,False,False,False,False,False,False,False,False,False,False,False,False,False,False,False,False,False,False,False,False,False,False,False,False,False,False,False,False,False,False,False,False,False,False,False,False,False,False,False,False,False,False,False,71.0,30.0,54.0,61.0,76.0,76.0,50,29,74,66,22,60,39,25,64,65,64,77,46,73,53,46,77,72,79,19,75,74,24,39,35,73.0,76,77,74,9,10,6,13,9,,52+2,52+2,52+2,53,52,52,52,53,53+2,53+2,53+2,57+2,58+2,58+2,58+2,57+2,69+2,70+2,70+2,70+2,69+2,71+2,75+2,75+2,75+2,71+2,17+2,CB,258607,LCB|CB,69,76,2600000.0,24000.0,23,187,83,13.0,Left,3,2,1,Medium/Medium,Normal (185+),False,False,False,False,False,False,False,False,False,False,False,False,False,False,False,False,False,False,False,False,False,False,False,False,False,False,False,False,False,False,False,False,False,False,False,False,False,False,False,False,False,False,False,False,76.0,47.0,60.0,61.0,69.0,72.0,59,42,60,64,42,58,48,48,63,62,73,78,65,71,61,55,67,62,78,49,70,69,56,58,45,66.0,70,70,71,11,6,12,5,10,,59+2,59+2,59+2,60,60,60,60,60,60+2,60+2,60+2,62+2,62+2,62+2,62+2,62+2,67+2,67+2,67+2,67+2,67+2,68+2,69+2,69+2,69+2,68+2,15+2,CB,227928,RM|RWB|RB,80,80,19000000.0,84000.0,28,177,69,13.0,Right,3,4,2,High/Medium,Unique,False,False,False,False,False,False,False,False,False,False,False,False,False,False,False,False,False,False,False,False,False,False,False,False,False,False,False,False,False,False,False,False,False,False,False,False,False,False,False,False,False,False,False,False,83.0,57.0,69.0,80.0,75.0,74.0,77,50,58,75,42,80,63,34,65,80,84,82,80,79,79,74,81,78,68,58,81,77,73,63,38,79.0,74,79,76,16,12,10,14,12,,69+2,69+2,69+2,74,73,73,73,74,73+2,73+2,73+2,75+2,73+2,73+2,73+2,75+2,78+2,75+2,75+2,75+2,78+2,77+2,75+2,75+2,75+2,77+2,21+2,RWB,224293,CDM|CM,83,86,47500000.0,105000.0,25,180,80,13.0,Right,4,3,2,Low/High,Normal (170-185),False,False,False,False,False,False,False,False,False,False,False,False,False,False,False,False,False,False,False,False,False,False,False,False,False,False,False,False,False,False,False,False,False,False,False,False,False,False,False,False,False,False,False,False,58.0,74.0,86.0,77.0,76.0,73.0,80,65,53,88,82,75,85,81,88,82,63,54,68,80,72,85,66,79,67,82,83,80,62,87,76,86.0,77,79,76,16,12,10,8,10,,70+2,70+2,70+2,74,75,75,75,74,78+2,78+2,78+2,76+2,82+2,82+2,82+2,76+2,78+2,81+2,81+2,81+2,78+2,76+2,75+2,75+2,75+2,76+2,19+2,CM,162347,CDM|CM,81,81,10500000.0,70000.0,35,170,61,13.0,Right,4,3,3,Medium/Medium,Normal (170-),False,False,False,False,False,False,False,False,False,False,False,False,False,False,False,False,False,False,False,False,False,False,False,False,False,False,False,False,False,False,False,False,False,False,False,False,False,False,False,False,False,False,False,False,47.0,71.0,84.0,79.0,71.0,66.0,82,68,66,87,74,76,82,78,84,85,54,42,72,75,85,76,69,75,57,74,74,71,68,84,70,90.0,73,72,69,13,15,15,13,13,,70+3,70+3,70+3,74,74,74,74,74,77+3,77+3,77+3,75+3,80+1,80+1,80+1,75+3,74+3,77+3,77+3,77+3,74+3,72+3,70+3,70+3,70+3,72+3,20+3,CM,253124,CDM|CM,79,86,35000000.0,73000.0,23,183,76,13.0,Right,3,3,1,High/Medium,Normal (170-185),False,False,False,False,False,False,False,False,False,False,False,False,False,False,False,False,False,False,False,False,False,False,False,False,False,False,False,False,False,False,False,False,False,False,False,False,False,False,False,False,False,False,False,False,82.0,71.0,73.0,82.0,74.0,76.0,59,71,53,79,57,84,74,58,77,82,81,83,74,83,75,77,54,86,74,68,76,78,79,77,59,79.0,76,75,74,13,10,12,12,13,,75+2,75+2,75+2,78,79,79,79,78,79+2,79+2,79+2,78+2,79+2,79+2,79+2,78+2,77+2,78+2,78+2,78+2,77+2,76+2,74+2,74+2,74+2,76+2,20+2,CM,210455,LM|LWB|LB,79,79,16000000.0,80000.0,28,170,70,13.0,Right,3,3,2,High/High,Normal (170-),False,False,False,False,False,False,False,False,False,False,False,False,False,False,False,False,False,False,False,False,False,False,False,False,False,False,False,False,False,False,False,False,False,False,False,False,False,False,False,False,False,False,False,False,74.0,54.0,71.0,76.0,78.0,69.0,76,51,69,76,46,76,66,54,64,77,77,71,73,76,80,68,75,77,59,49,80,79,67,67,46,74.0,78,81,79,7,10,12,10,6,,66+2,66+2,66+2,71,70,70,70,71,70+2,70+2,70+2,73+2,72+2,72+2,72+2,73+2,77+2,75+2,75+2,75+2,77+2,77+2,76+2,76+2,76+2,77+2,16+2,LWB,204838,CF|ST,82,82,25500000.0,110000.0,31,188,81,13.0,Right,4,3,3,Medium/High,Normal (185+),False,False,False,False,False,False,False,False,False,False,False,False,False,False,False,False,False,False,False,False,False,False,False,False,False,False,False,False,False,False,False,False,False,False,False,False,False,False,False,False,False,False,False,False,73.0,81.0,76.0,80.0,47.0,82.0,73,81,80,81,80,82,75,51,75,80,66,79,72,82,65,84,74,79,85,74,82,53,82,78,92,81.0,45,38,30,7,11,13,14,10,,81+1,81+1,81+1,79,80,80,80,79,79+3,79+3,79+3,79+3,76+3,76+3,76+3,79+3,64+3,65+3,65+3,65+3,64+3,61+3,60+3,60+3,60+3,61+3,18+3,ST,224411,CF|ST,82,85,41000000.0,105000.0,25,179,68,13.0,Right,4,4,2,High/Low,Normal (170-185),False,False,False,False,False,False,False,False,False,False,False,False,False,False,False,False,False,False,False,False,False,False,False,False,False,False,False,False,False,False,False,False,False,False,False,False,False,False,False,False,False,False,False,False,86.0,83.0,74.0,83.0,38.0,70.0,81,82,75,70,75,84,76,70,69,82,85,87,84,81,75,87,63,72,72,88,64,50,79,76,69,78.0,24,34,30,9,12,11,9,9,,81+2,81+2,81+2,81,81,81,81,81,79+2,79+2,79+2,80+2,73+2,73+2,73+2,80+2,63+2,59+2,59+2,59+2,63+2,59+2,52+2,52+2,52+2,59+2,18+2,ST
11,7.0,2022.0,3-5-2,to_be_implemented,204935,GK,82,84,26000000.0,45000.0,28,185,77,13.0,Left,4,1,3,Medium/Medium,Normal (185+),False,False,False,False,False,False,False,False,False,False,False,False,False,False,False,False,False,False,False,False,False,False,False,False,False,False,False,False,False,False,False,False,False,False,False,False,False,False,False,False,False,False,False,False,,,,,,,17,19,15,58,20,14,18,16,60,40,56,44,57,75,55,65,77,45,70,13,45,24,18,69,45,65.0,21,20,12,84,77,87,80,87,51.0,36+3,36+3,36+3,36,39,39,39,36,43+3,43+3,43+3,40+3,46+3,46+3,46+3,40+3,34+3,42+3,42+3,42+3,34+3,33+3,34+3,34+3,34+3,33+3,81+3,GK,202048,RCB|CB,79,79,14500000.0,80000.0,29,186,80,13.0,Right,3,2,1,Low/High,Normal (185+),False,False,False,False,False,False,False,False,False,False,False,False,False,False,False,False,False,False,False,False,False,False,False,False,False,False,False,False,False,False,False,False,False,False,False,False,False,False,False,False,False,False,False,False,47.0,57.0,75.0,66.0,79.0,73.0,67,51,77,81,56,60,60,57,85,79,41,51,48,79,54,68,84,73,74,60,66,79,51,72,60,80.0,80,80,74,8,15,10,12,8,,64+2,64+2,64+2,63,65,65,65,63,67+2,67+2,67+2,66+2,75+2,75+2,75+2,66+2,73+2,78+1,78+1,78+1,73+2,73+2,77+2,77+2,77+2,73+2,18+2,CB,202695,CB,79,79,14500000.0,45000.0,29,188,81,13.0,Right,4,2,1,Low/High,Normal (185+),False,False,False,False,False,False,False,False,False,False,False,False,False,False,False,False,False,False,False,False,False,False,False,False,False,False,False,False,False,False,False,False,False,False,False,False,False,False,False,False,False,False,False,False,55.0,45.0,65.0,62.0,81.0,80.0,59,40,82,67,40,60,54,53,73,65,49,60,55,78,53,63,85,67,84,38,83,80,43,65,52,78.0,81,81,79,14,8,12,9,7,,59+2,59+2,59+2,57,58,58,58,57,60+2,60+2,60+2,61+2,66+2,66+2,66+2,61+2,70+2,75+2,75+2,75+2,70+2,72+2,79,79,79,72+2,17+2,CB,207599,LCB|CB,79,80,16000000.0,45000.0,29,191,82,13.0,Right,2,2,2,Medium/Medium,Normal (185+),False,False,False,False,False,False,False,False,False,False,False,False,False,False,False,False,False,False,False,False,False,False,False,False,False,False,False,False,False,False,False,False,False,False,False,False,False,False,False,False,False,False,False,False,52.0,49.0,63.0,62.0,80.0,79.0,57,50,82,70,40,61,53,33,72,65,50,53,52,76,54,58,85,65,86,46,77,78,29,60,48,72.0,80,81,77,16,7,8,14,11,,58+2,58+2,58+2,57,57,57,57,57,59+2,59+2,59+2,59+2,65+2,65+2,65+2,59+2,69+2,74+2,74+2,74+2,69+2,71+2,79+1,79+1,79+1,71+2,19+2,CB,180216,RM|RWB|RB,76,76,3900000.0,34000.0,33,177,77,13.0,Right,3,3,2,High/High,Normal (170-185),False,False,False,False,False,False,False,False,False,False,False,False,False,False,False,False,False,False,False,False,False,False,False,False,False,False,False,False,False,False,False,False,False,False,False,False,False,False,False,False,False,False,False,False,65.0,65.0,72.0,76.0,77.0,70.0,75,61,65,77,64,77,65,53,69,75,66,64,70,76,74,74,71,65,68,66,80,77,70,70,55,82.0,76,80,79,5,15,10,13,7,,69+2,69+2,69+2,72,71,71,71,72,72+2,72+2,72+2,72+2,73+2,73+2,73+2,72+2,74+2,75+1,75+1,75+1,74+2,74+2,75+1,75+1,75+1,74+2,17+2,RB,193474,CDM|CM,82,82,20500000.0,53000.0,32,174,66,13.0,Right,3,3,2,Medium/High,Lean (170-185),False,False,False,False,False,False,False,False,False,False,False,False,False,False,False,False,False,False,False,False,False,False,False,False,False,False,False,False,False,False,False,False,False,False,False,False,False,False,False,False,False,False,False,False,67.0,66.0,72.0,78.0,83.0,76.0,60,60,69,80,36,76,60,66,76,79,69,66,78,81,81,82,83,85,68,72,83,86,72,70,55,79.0,82,87,83,8,6,8,12,13,,71+2,71+2,71+2,72,74,74,74,72,74+2,74+2,74+2,73+2,78+2,78+2,78+2,73+2,78+2,81+1,81+1,81+1,78+2,79+2,80+2,80+2,80+2,79+2,18+2,CDM,199914,CDM|CM,80,80,15000000.0,46000.0,31,175,74,13.0,Right,3,4,2,Medium/High,Stocky (170-185),False,False,False,False,False,False,False,False,False,False,False,False,False,False,False,False,False,False,False,False,False,False,False,False,False,False,False,False,False,False,False,False,False,False,False,False,False,False,False,False,False,False,False,False,70.0,69.0,73.0,79.0,79.0,77.0,70,71,56,78,56,78,68,49,75,79,74,67,76,81,86,73,64,89,68,66,89,74,77,71,53,85.0,82,85,82,13,13,5,5,8,,72+2,72+2,72+2,75,75,75,75,75,76+2,76+2,76+2,76+2,77+2,77+2,77+2,76+2,78+2,79+1,79+1,79+1,78+2,78+2,77+2,77+2,77+2,78+2,17+2,CDM,208135,CDM|CM,79,79,17000000.0,49000.0,29,184,76,13.0,Right,3,3,2,High/High,Unique,False,False,False,False,False,False,False,False,False,False,False,False,False,False,False,False,False,False,False,False,False,False,False,False,False,False,False,False,False,False,False,False,False,False,False,False,False,False,False,False,False,False,False,False,67.0,76.0,74.0,78.0,78.0,82.0,69,75,69,81,68,79,44,52,77,81,66,67,65,79,67,84,74,89,81,77,78,81,77,75,54,77.0,76,80,76,15,12,12,15,14,,77+2,77+2,77+2,76,77,77,77,76,77+2,77+2,77+2,77+2,79,79,79,77+2,78+1,80-1,80-1,80-1,78+1,77+2,78+1,78+1,78+1,77+2,21+2,CM,220633,LM|LWB|LB,77,78,12500000.0,40000.0,26,183,75,13.0,Right,4,4,2,High/Medium,Lean (170-185),False,False,False,False,False,False,False,False,False,False,False,False,False,False,False,False,False,False,False,False,False,False,False,False,False,False,False,False,False,False,False,False,False,False,False,False,False,False,False,False,False,False,False,False,86.0,76.0,69.0,81.0,37.0,58.0,73,77,31,70,54,84,72,60,60,82,87,86,81,68,78,82,51,70,59,75,41,25,74,72,61,73.0,42,45,31,6,11,11,13,10,,72+2,72+2,72+2,78,77,77,77,78,76+2,76+2,76+2,76+2,69+2,69+2,69+2,76+2,60+2,54+2,54+2,54+2,60+2,56+2,45+2,45+2,45+2,56+2,16+2,LM,221479,CF|ST,80,84,29500000.0,52000.0,25,187,71,13.0,Right,2,3,2,High/Medium,Unique,False,False,False,False,False,False,False,False,False,False,False,False,False,False,False,False,False,False,False,False,False,False,False,False,False,False,False,False,False,False,False,False,False,False,False,False,False,False,False,False,False,False,False,False,81.0,77.0,64.0,76.0,39.0,80.0,65,81,89,71,72,76,64,54,47,79,73,87,68,79,64,79,91,76,82,65,78,35,80,64,77,76.0,38,31,23,12,12,8,7,11,,80+2,80+2,80+2,75,77,77,77,75,73+2,73+2,73+2,74+2,66+2,66+2,66+2,74+2,58+2,56+2,56+2,56+2,58+2,56+2,55+2,55+2,55+2,56+2,18+2,ST,211784,CF|ST,76,78,9500000.0,39000.0,25,173,69,13.0,Right,4,3,1,Medium/Medium,Normal (170-185),False,False,False,False,False,False,False,False,False,False,False,False,False,False,False,False,False,False,False,False,False,False,False,False,False,False,False,False,False,False,False,False,False,False,False,False,False,False,False,False,False,False,False,False,74.0,77.0,67.0,73.0,41.0,72.0,61,79,73,74,76,68,63,55,59,76,77,72,76,79,81,79,59,78,67,71,80,26,82,69,78,70.0,30,55,33,11,12,7,8,14,,76+2,76+2,76+2,73,75,75,75,73,74+2,74+2,74+2,73+2,69+2,69+2,69+2,73+2,58+2,58+2,58+2,58+2,58+2,57+2,54+2,54+2,54+2,57+2,18+2,ST
12,1799.0,2022.0,4-3-2-1,to_be_implemented,189690,GK,79,79,1900000.0,29000.0,35,190,80,13.0,Right,3,1,2,Medium/Medium,Normal (185+),False,False,False,False,False,False,False,False,False,False,False,False,False,False,False,False,False,False,False,False,False,False,False,False,False,False,False,False,False,False,False,False,False,False,False,False,False,False,False,False,False,False,False,False,,,,,,,34,11,20,44,13,16,32,20,36,24,51,52,63,74,48,59,68,41,62,15,24,27,13,54,29,62.0,23,15,17,80,77,78,77,81,51.0,32+2,32+2,32+2,33,33,33,33,33,35+2,35+2,35+2,35+2,36+2,36+2,36+2,35+2,34+2,34+2,34+2,34+2,34+2,33+2,31+2,31+2,31+2,33+2,78+1,GK,186392,RB|RWB,74,74,2900000.0,39000.0,32,188,83,13.0,Right,3,3,1,Medium/High,Lean (185+),False,False,False,False,False,False,False,False,False,False,False,False,False,False,False,False,False,False,False,False,False,False,False,False,False,False,False,False,False,False,False,False,False,False,False,False,False,False,False,False,False,False,False,False,54.0,52.0,68.0,66.0,77.0,70.0,73,46,74,72,33,64,50,34,69,69,52,55,61,74,53,64,67,64,71,59,74,78,64,66,40,72.0,77,76,77,8,7,7,10,11,,62+2,62+2,62+2,64,64,64,64,64,65+2,65+2,65+2,65+2,69+2,69+2,69+2,65+2,71+2,73+1,73+1,73+1,71+2,72+2,74,74,74,72+2,16+2,RB,241159,LCB|CB,78,86,29500000.0,36000.0,21,182,82,13.0,Right,4,2,1,Medium/Medium,Normal (170-185),False,False,False,False,False,False,False,False,False,False,False,False,False,False,False,False,False,False,False,False,False,False,False,False,False,False,False,False,False,False,False,False,False,False,False,False,False,False,False,False,False,False,False,False,73.0,39.0,58.0,68.0,79.0,75.0,35,42,76,74,32,65,42,32,73,70,67,77,67,80,65,49,70,70,79,26,73,79,35,54,38,74.0,81,79,78,8,9,11,12,12,,58+2,58+2,58+2,59,59,59,59,59,61+2,61+2,61+2,62+2,66+2,66+2,66+2,62+2,71+2,75+2,75+2,75+2,71+2,73+2,78+2,78+2,78+2,73+2,18+2,CB,224221,RCB|CB,77,80,12000000.0,48000.0,26,192,90,13.0,Right,3,2,2,Medium/Medium,Normal (185+),False,False,False,False,False,False,False,False,False,False,False,False,False,False,False,False,False,False,False,False,False,False,False,False,False,False,False,False,False,False,False,False,False,False,False,False,False,False,False,False,False,False,False,False,52.0,50.0,68.0,64.0,77.0,80.0,47,40,76,79,43,63,64,50,85,70,53,52,48,77,52,73,74,69,86,53,80,77,42,63,44,75.0,78,78,76,13,7,9,15,14,,61+2,61+2,61+2,59,61,61,61,59,63+2,63+2,63+2,62+2,70+2,70+2,70+2,62+2,69+2,77+2,77+2,77+2,69+2,70+2,77+2,77+2,77+2,70+2,19+2,CB,240947,LB|LWB,76,83,14500000.0,38000.0,22,180,70,13.0,Left,3,2,1,High/High,Lean (170-185),False,False,False,False,False,False,False,False,False,False,False,False,False,False,False,False,False,False,False,False,False,False,False,False,False,False,False,False,False,False,False,False,False,False,False,False,False,False,False,False,False,False,False,False,77.0,39.0,60.0,70.0,75.0,68.0,69,36,53,63,36,68,52,39,53,70,78,76,78,76,75,40,57,74,63,38,74,78,59,59,45,61.0,76,79,77,9,12,14,8,14,,56+2,56+2,56+2,64,61,61,61,64,63+2,63+2,63+2,66+2,64+2,64+2,64+2,66+2,74+2,71+2,71+2,71+2,74+2,74+2,72+2,72+2,72+2,74+2,18+2,LB,242619,CDM|CM,76,78,10000000.0,42000.0,22,180,73,13.0,Right,3,3,1,Medium/High,Normal (170-185),False,False,False,False,False,False,False,False,False,False,False,False,False,False,False,False,False,False,False,False,False,False,False,False,False,False,False,False,False,False,False,False,False,False,False,False,False,False,False,False,False,False,False,False,68.0,57.0,71.0,76.0,74.0,76.0,54,56,58,79,48,76,59,47,77,79,66,69,72,76,71,59,66,78,77,56,75,76,67,77,52,77.0,72,80,74,10,14,12,12,15,,66+2,66+2,66+2,70,71,71,71,70,73+2,73+2,73+2,72+2,76+2,76+2,76+2,72+2,73+2,77+1,77+1,77+1,73+2,73+2,74+2,74+2,74+2,73+2,20+2,CM,171972,CDM|CM,75,75,1900000.0,42000.0,34,178,66,13.0,Right,3,3,1,High/High,Normal (170-185),False,False,False,False,False,False,False,False,False,False,False,False,False,False,False,False,False,False,False,False,False,False,False,False,False,False,False,False,False,False,False,False,False,False,False,False,False,False,False,False,False,False,False,False,52.0,67.0,71.0,72.0,74.0,68.0,66,68,66,75,57,70,58,61,73,75,54,51,65,77,71,65,68,68,60,67,88,74,75,71,64,80.0,76,76,71,9,9,9,9,9,,68+2,68+2,68+2,69,70,70,70,69,71+2,71+2,71+2,69+2,73+2,73+2,73+2,69+2,70+2,74+1,74+1,74+1,70+2,70+2,73+2,73+2,73+2,70+2,16+2,CDM,206516,CDM|CM,75,76,6500000.0,46000.0,27,185,74,13.0,Left,3,4,1,Medium/Medium,Lean (185+),False,False,False,False,False,False,False,False,False,False,False,False,False,False,False,False,False,False,False,False,False,False,False,False,False,False,False,False,False,False,False,False,False,False,False,False,False,False,False,False,False,False,False,False,48.0,64.0,77.0,76.0,68.0,63.0,76,67,58,80,50,77,67,62,76,78,65,34,68,75,67,60,49,72,58,62,70,65,72,80,66,79.0,69,71,69,7,15,12,9,12,,66+2,66+2,66+2,72,71,71,71,72,74+2,74+2,74+2,73+2,75+1,75+1,75+1,73+2,70+2,72+2,72+2,72+2,70+2,68+2,67+2,67+2,67+2,68+2,18+2,CM,235794,CAM|CF,76,81,11500000.0,42000.0,24,178,67,13.0,Right,3,4,1,Medium/Medium,Lean (170-185),False,False,False,False,False,False,False,False,False,False,False,False,False,False,False,False,False,False,False,False,False,False,False,False,False,False,False,False,False,False,False,False,False,False,False,False,False,False,False,False,False,False,False,False,75.0,70.0,74.0,81.0,47.0,67.0,70,71,49,78,55,82,71,68,69,80,76,75,82,73,79,68,67,74,68,72,58,49,72,76,69,79.0,36,57,40,10,12,9,14,10,,71+2,71+2,71+2,76,75,75,75,76,76+2,76+2,76+2,76+2,73+2,73+2,73+2,76+2,64+2,63+2,63+2,63+2,64+2,61+2,55+2,55+2,55+2,61+2,18+2,CAM,198717,CAM|CF,82,82,30000000.0,85000.0,29,180,66,13.0,Right,3,5,2,High/High,Unique,False,False,False,False,False,False,False,False,False,False,False,False,False,False,False,False,False,False,False,False,False,False,False,False,False,False,False,False,False,False,False,False,False,False,False,False,False,False,False,False,False,False,False,False,91.0,79.0,73.0,86.0,37.0,76.0,75,81,47,76,68,88,71,54,69,87,90,91,85,74,75,83,58,78,77,72,77,35,76,72,78,81.0,34,39,36,15,10,15,11,10,,78+2,78+2,78+2,81,80,80,80,81,80+2,80+2,80+2,81+1,73+2,73+2,73+2,81+1,64+2,60+2,60+2,60+2,64+2,59+2,52+2,52+2,52+2,59+2,19+2,LW,233866,CF|ST,76,82,12000000.0,46000.0,24,187,83,13.0,Right,4,4,1,High/Medium,Normal (185+),False,False,False,False,False,False,False,False,False,False,False,False,False,False,False,False,False,False,False,False,False,False,False,False,False,False,False,False,False,False,False,False,False,False,False,False,False,False,False,False,False,False,False,False,79.0,75.0,68.0,79.0,45.0,75.0,58,79,72,73,62,80,75,77,58,79,77,81,79,69,79,77,73,77,82,69,55,39,74,74,76,82.0,44,46,28,7,6,13,11,13,,76+2,76+2,76+2,75,76,76,76,75,75+2,75+2,75+2,74+2,69+2,69+2,69+2,74+2,59+2,59+2,59+2,59+2,59+2,57+2,55+2,55+2,55+2,57+2,16+2,ST
13,1943.0,2022.0,3-5-2,to_be_implemented,194404,GK,81,81,13000000.0,47000.0,32,190,84,13.0,Right,2,1,2,Medium/Medium,Lean (185+),False,False,False,False,False,False,False,False,False,False,False,False,False,False,False,False,False,False,False,False,False,False,False,False,False,False,False,False,False,False,False,False,False,False,False,False,False,False,False,False,False,False,False,False,,,,,,,11,15,14,36,12,19,12,13,41,24,56,52,59,77,49,58,83,40,61,20,40,15,11,42,22,64.0,17,14,15,82,78,77,78,80,54.0,32+2,32+2,32+2,31,32,32,32,31,33+2,33+2,33+2,32+2,33+2,33+2,33+2,32+2,29+2,32+2,32+2,32+2,29+2,28+2,29+2,29+2,29+2,28+2,79+2,GK,236506,RCB|CB,78,83,18500000.0,44000.0,25,183,78,13.0,Left,3,3,2,Medium/Medium,Normal (170-185),False,False,False,False,False,False,False,False,False,False,False,False,False,False,False,False,False,False,False,False,False,False,False,False,False,False,False,False,False,False,False,False,False,False,False,False,False,False,False,False,False,False,False,False,60.0,42.0,69.0,74.0,79.0,78.0,63,32,77,76,58,75,41,32,77,76,67,54,66,73,61,55,81,75,80,52,74,80,32,75,40,75.0,82,77,77,10,13,11,7,8,,58+2,58+2,58+2,63,61,61,61,63,66+2,66+2,66+2,66+2,71+2,71+2,71+2,66+2,73+2,77+2,77+2,77+2,73+2,74+2,78+2,78+2,78+2,74+2,17+2,CB,202697,CB,74,74,3600000.0,41000.0,28,185,75,13.0,Right,2,2,1,Medium/Medium,Normal (185+),False,False,False,False,False,False,False,False,False,False,False,False,False,False,False,False,False,False,False,False,False,False,False,False,False,False,False,False,False,False,False,False,False,False,False,False,False,False,False,False,False,False,False,False,50.0,42.0,61.0,67.0,75.0,73.0,47,36,75,70,34,67,55,58,67,70,49,50,63,71,55,55,67,64,78,42,72,74,47,56,42,62.0,75,78,72,13,10,11,13,10,,57+2,57+2,57+2,57,58,58,58,57,60+2,60+2,60+2,59+2,65+2,65+2,65+2,59+2,66+2,71+2,71+2,71+2,66+2,67+2,74,74,74,67+2,18+2,CB,231512,LCB|CB,73,80,5500000.0,28000.0,23,190,76,13.0,Left,3,3,1,Medium/Medium,Lean (185+),False,False,False,False,False,False,False,False,False,False,False,False,False,False,False,False,False,False,False,False,False,False,False,False,False,False,False,False,False,False,False,False,False,False,False,False,False,False,False,False,False,False,False,False,72.0,40.0,62.0,68.0,74.0,75.0,64,34,71,67,35,67,44,42,65,71,68,75,62,70,63,50,71,71,78,41,73,72,58,59,45,69.0,73,76,74,7,8,8,11,12,,59+2,59+2,59+2,62,61,61,61,62,62+2,62+2,62+2,65+2,65+2,65+2,65+2,65+2,71+2,71+2,71+2,71+2,71+2,71+2,73+2,73+2,73+2,71+2,16+2,CB,205346,RM|RWB|RB,75,75,4900000.0,40000.0,29,181,74,13.0,Right,3,3,1,High/Medium,Normal (170-185),False,False,False,False,False,False,False,False,False,False,False,False,False,False,False,False,False,False,False,False,False,False,False,False,False,False,False,False,False,False,False,False,False,False,False,False,False,False,False,False,False,False,False,False,91.0,51.0,66.0,73.0,69.0,67.0,73,47,56,72,51,74,64,42,60,71,89,92,75,71,76,58,62,68,65,46,73,69,65,60,61,63.0,71,71,73,16,7,8,15,9,,64+2,64+2,64+2,70,67,67,67,70,68+2,68+2,68+2,71+2,66+2,66+2,66+2,71+2,73+2,69+2,69+2,69+2,73+2,73+2,69+2,69+2,69+2,73+2,18+2,RB,213991,CDM|CM,75,75,5500000.0,38000.0,27,179,70,13.0,Right,4,3,1,Medium/Medium,Normal (170-185),False,False,False,False,False,False,False,False,False,False,False,False,False,False,False,False,False,False,False,False,False,False,False,False,False,False,False,False,False,False,False,False,False,False,False,False,False,False,False,False,False,False,False,False,70.0,64.0,69.0,72.0,72.0,81.0,66,56,65,75,56,70,66,65,70,74,68,71,70,71,76,79,87,81,77,73,88,72,59,64,58,73.0,73,73,75,16,14,11,7,9,,67+2,67+2,67+2,68,68,68,68,68,69+2,69+2,69+2,69+2,71+2,71+2,71+2,69+2,73+2,74+1,74+1,74+1,73+2,73+2,74+1,74+1,74+1,73+2,18+2,CDM,220714,CDM|CM,75,78,7500000.0,42000.0,26,197,80,13.0,Left,3,3,1,Medium/Medium,Lean (185+),False,False,False,False,False,False,False,False,False,False,False,False,False,False,False,False,False,False,False,False,False,False,False,False,False,False,False,False,False,False,False,False,False,False,False,False,False,False,False,False,False,False,False,False,58.0,71.0,71.0,72.0,72.0,79.0,62,67,73,76,68,74,74,68,74,76,51,63,54,76,49,84,61,81,80,73,76,74,73,71,52,75.0,70,74,70,11,7,10,14,13,,73+2,73+2,73+2,70,72,72,72,70,72+2,72+2,72+2,71+2,75+2,75+2,75+2,71+2,71+2,75+2,75+2,75+2,71+2,71+2,73+2,73+2,73+2,71+2,18+2,CM,224294,CDM|CM,74,78,6000000.0,37000.0,25,175,71,13.0,Right,4,3,1,Medium/Medium,Normal (170-185),False,False,False,False,False,False,False,False,False,False,False,False,False,False,False,False,False,False,False,False,False,False,False,False,False,False,False,False,False,False,False,False,False,False,False,False,False,False,False,False,False,False,False,False,60.0,63.0,74.0,77.0,66.0,66.0,70,61,50,77,57,77,71,65,77,78,66,55,75,73,83,66,68,68,61,65,77,69,65,74,61,73.0,64,72,68,6,15,12,15,13,,65+2,65+2,65+2,71,70,70,70,71,72+2,72+2,72+2,71+2,74+2,74+2,74+2,71+2,70+2,72+2,72+2,72+2,70+2,68+2,67+2,67+2,67+2,68+2,19+2,CM,259634,LM|LWB|LB,70,77,3100000.0,19000.0,22,173,75,13.0,Left,3,2,1,High/Medium,Normal (170-185),False,False,False,False,False,False,False,False,False,False,False,False,False,False,False,False,False,False,False,False,False,False,False,False,False,False,False,False,False,False,False,False,False,False,False,False,False,False,False,False,False,False,False,False,82.0,39.0,59.0,67.0,63.0,61.0,62,41,44,67,26,66,56,29,52,66,83,82,70,68,72,42,64,76,55,31,58,66,55,55,42,60.0,65,66,65,11,10,13,8,8,,55+2,55+2,55+2,63,60,60,60,63,61+2,61+2,61+2,65+2,61+2,61+2,61+2,65+2,68+2,64+2,64+2,64+2,68+2,68+2,62+2,62+2,62+2,68+2,16+2,LB,225539,CF|ST,75,79,8000000.0,40000.0,24,187,80,13.0,Right,3,3,1,High/Medium,Lean (185+),False,False,False,False,False,False,False,False,False,False,False,False,False,False,False,False,False,False,False,False,False,False,False,False,False,False,False,False,False,False,False,False,False,False,False,False,False,False,False,False,False,False,False,False,71.0,74.0,64.0,73.0,28.0,78.0,54,76,74,72,74,75,56,47,59,75,64,77,64,74,67,75,77,87,79,69,65,22,75,71,72,73.0,21,25,22,9,15,14,9,10,,75+2,75+2,75+2,71,74,74,74,71,72+2,72+2,72+2,71+2,67+2,67+2,67+2,71+2,53+2,52+2,52+2,52+2,53+2,50+2,46+2,46+2,46+2,50+2,18+2,ST,216627,CF|ST,73,73,3000000.0,40000.0,29,196,83,13.0,Right,3,3,1,Medium/Medium,Normal (185+),False,False,False,False,False,False,False,False,False,False,False,False,False,False,False,False,False,False,False,False,False,False,False,False,False,False,False,False,False,False,False,False,False,False,False,False,False,False,False,False,False,False,False,False,70.0,70.0,56.0,67.0,46.0,80.0,58,73,84,58,68,68,62,45,55,71,63,76,52,70,50,76,75,66,90,58,73,42,73,54,67,68.0,39,44,39,10,10,13,8,9,,73,73,73,66,68,68,68,66,64+2,64+2,64+2,66+2,61+2,61+2,61+2,66+2,56+2,56+2,56+2,56+2,56+2,55+2,58+2,58+2,58+2,55+2,16+2,ST
14,17.0,2022.0,3-5-2,to_be_implemented,189324,GK,75,75,2800000.0,34000.0,32,193,79,13.0,Right,2,1,1,Medium/Medium,Lean (185+),False,False,False,False,False,False,False,False,False,False,False,False,False,False,False,False,False,False,False,False,False,False,False,False,False,False,False,False,False,False,False,False,False,False,False,False,False,False,False,False,False,False,False,False,,,,,,,11,17,16,33,12,17,15,18,35,17,58,56,35,74,43,46,68,35,63,14,35,22,16,50,41,61.0,13,13,12,74,72,61,72,80,57.0,31+2,31+2,31+2,29,31,31,31,29,32+2,32+2,32+2,31+2,32+2,32+2,32+2,31+2,28+2,30+2,30+2,30+2,28+2,27+2,28+2,28+2,28+2,27+2,74+1,GK,225263,RCB|CB,78,82,17500000.0,48000.0,25,192,89,13.0,Right,3,2,2,Medium/High,Normal (185+),False,False,False,False,False,False,False,False,False,False,False,False,False,False,False,False,False,False,False,False,False,False,False,False,False,False,False,False,False,False,False,False,False,False,False,False,False,False,False,False,False,False,False,False,59.0,39.0,59.0,62.0,79.0,81.0,28,32,76,76,32,59,28,31,76,69,58,60,42,76,58,67,82,71,87,27,80,79,54,64,38,81.0,80,78,78,8,9,9,10,8,,59+2,59+2,59+2,56,60,60,60,56,61+2,61+2,61+2,60+2,68+2,68+2,68+2,60+2,68+2,76+2,76+2,76+2,68+2,70+2,78+2,78+2,78+2,70+2,16+2,CB,244915,CB,77,85,22000000.0,41000.0,23,191,85,13.0,Left,3,2,1,Medium/High,Normal (185+),False,False,False,False,False,False,False,False,False,False,False,False,False,False,False,False,False,False,False,False,False,False,False,False,False,False,False,False,False,False,False,False,False,False,False,False,False,False,False,False,False,False,False,False,69.0,36.0,51.0,55.0,79.0,80.0,40,30,74,73,22,47,50,32,58,64,63,74,53,68,49,60,72,67,87,28,79,81,35,24,40,62.0,79,79,75,7,7,11,10,6,,54+2,54+2,54+2,51,51,51,51,51,51+2,51+2,51+2,54+2,57+2,57+2,57+2,54+2,68+2,71+2,71+2,71+2,68+2,71+2,77+2,77+2,77+2,71+2,14+2,CB,247497,LCB|CB,73,83,6000000.0,26000.0,20,190,87,13.0,Right,5,2,1,Medium/Medium,Stocky (185+),False,False,False,False,False,False,False,False,False,False,False,False,False,False,False,False,False,False,False,False,False,False,False,False,False,False,False,False,False,False,False,False,False,False,False,False,False,False,False,False,False,False,False,False,82.0,25.0,50.0,51.0,74.0,76.0,31,20,72,66,24,39,22,22,64,60,77,86,60,59,63,40,77,65,86,20,65,77,29,46,33,57.0,69,77,72,12,14,5,8,13,,48+2,48+2,48+2,48,48,48,48,48,50+2,50+2,50+2,52+2,56+2,56+2,56+2,52+2,64+2,68+2,68+2,68+2,64+2,68+2,73+2,73+2,73+2,68+2,17+2,CB,227927,RM|RWB|RB,78,83,19000000.0,48000.0,25,174,64,13.0,Right,4,3,1,High/Medium,Lean (170-185),False,False,False,False,False,False,False,False,False,False,False,False,False,False,False,False,False,False,False,False,False,False,False,False,False,False,False,False,False,False,False,False,False,False,False,False,False,False,False,False,False,False,False,False,76.0,43.0,68.0,76.0,74.0,71.0,78,41,65,73,30,76,56,31,62,78,77,76,74,75,80,45,75,85,64,45,70,72,65,64,32,73.0,73,79,75,9,8,7,11,12,,62+2,62+2,62+2,70,67,67,67,70,69+2,69+2,69+2,72+2,70+2,70+2,70+2,72+2,76+2,73+2,73+2,73+2,76+2,76+2,73+2,73+2,73+2,76+2,17+2,RB,205569,CDM|CM,81,82,29500000.0,69000.0,27,173,66,13.0,Right,3,3,2,High/High,Normal (170-185),False,False,False,False,False,False,False,False,False,False,False,False,False,False,False,False,False,False,False,False,False,False,False,False,False,False,False,False,False,False,False,False,False,False,False,False,False,False,False,False,False,False,False,False,59.0,74.0,86.0,78.0,67.0,73.0,90,71,57,85,51,76,93,94,84,82,66,54,75,75,76,82,65,91,64,79,76,67,68,82,79,79.0,64,74,65,12,12,10,15,15,,71+2,71+2,71+2,76,75,75,75,76,77+2,77+2,77+2,78+2,80+2,80+2,80+2,78+2,75+2,76+2,76+2,76+2,75+2,73+2,68+2,68+2,68+2,73+2,20+2,CM,231044,CDM|CM,75,78,7500000.0,44000.0,25,183,76,13.0,Left,3,4,1,High/High,Lean (170-185),False,False,False,False,False,False,False,False,False,False,False,False,False,False,False,False,False,False,False,False,False,False,False,False,False,False,False,False,False,False,False,False,False,False,False,False,False,False,False,False,False,False,False,False,80.0,68.0,72.0,78.0,68.0,76.0,66,67,65,76,63,78,68,59,72,77,79,80,82,72,79,73,73,84,76,67,69,69,72,76,66,75.0,64,72,70,14,13,11,5,7,,72+2,72+2,72+2,74,74,74,74,74,75+2,75+2,75+2,75+2,75+2,75+2,75+2,75+2,73+2,73+2,73+2,73+2,73+2,72+2,70+2,70+2,70+2,72+2,17+2,CM,239452,CDM|CM,74,82,9000000.0,34000.0,23,179,68,13.0,Right,3,3,1,Medium/High,Lean (170-185),False,False,False,False,False,False,False,False,False,False,False,False,False,False,False,False,False,False,False,False,False,False,False,False,False,False,False,False,False,False,False,False,False,False,False,False,False,False,False,False,False,False,False,False,65.0,48.0,65.0,70.0,71.0,74.0,52,41,59,74,36,69,52,39,72,70,68,62,71,68,77,55,62,78,71,54,78,74,57,68,64,67.0,72,74,69,8,9,8,14,6,,59+2,59+2,59+2,63,63,63,63,63,66+2,66+2,66+2,65+2,69+2,69+2,69+2,65+2,69+2,73+2,73+2,73+2,69+2,69+2,71+2,71+2,71+2,69+2,16+2,CDM,203362,LM|LWB|LB,76,76,8000000.0,49000.0,27,178,70,13.0,Right,4,4,1,Medium/Medium,Normal (170-185),False,False,False,False,False,False,False,False,False,False,False,False,False,False,False,False,False,False,False,False,False,False,False,False,False,False,False,False,False,False,False,False,False,False,False,False,False,False,False,False,False,False,False,False,77.0,74.0,71.0,78.0,55.0,70.0,72,75,72,74,69,80,74,64,63,77,76,77,80,72,79,75,77,81,64,74,69,36,74,70,64,70.0,58,59,51,12,7,8,7,13,,74+2,74+2,74+2,75,75,75,75,75,75+1,75+1,75+1,75+1,71+2,71+2,71+2,75+1,66+2,63+2,63+2,63+2,66+2,64+2,61+2,61+2,61+2,64+2,17+2,LM,226093,CF|ST,76,78,9500000.0,51000.0,25,178,70,13.0,Right,3,3,1,High/Medium,Stocky (170-185),False,False,False,False,False,False,False,False,False,False,False,False,False,False,False,False,False,False,False,False,False,False,False,False,False,False,False,False,False,False,False,False,False,False,False,False,False,False,False,False,False,False,False,False,81.0,77.0,62.0,75.0,40.0,77.0,55,76,63,70,70,73,63,59,53,77,78,84,78,74,74,86,76,77,79,75,74,36,77,62,69,70.0,33,42,36,16,13,12,15,9,,76+2,76+2,76+2,73,75,75,75,73,72+2,72+2,72+2,71+2,66+2,66+2,66+2,71+2,58+2,57+2,57+2,57+2,58+2,56+2,54+2,54+2,54+2,56+2,20+2,ST,221841,CF|ST,74,77,5500000.0,45000.0,25,172,69,13.0,Right,4,3,1,High/Low,Normal (170-185),False,False,False,False,False,False,False,False,False,False,False,False,False,False,False,False,False,False,False,False,False,False,False,False,False,False,False,False,False,False,False,False,False,False,False,False,False,False,False,False,False,False,False,False,84.0,75.0,66.0,75.0,35.0,69.0,62,75,66,70,68,73,69,63,58,72,88,80,87,76,90,77,85,73,61,76,79,41,75,67,70,72.0,36,23,25,10,13,13,12,7,,74+2,74+2,74+2,74,74,74,74,74,73+2,73+2,73+2,72+2,66+2,66+2,66+2,72+2,57+2,55+2,55+2,55+2,57+2,54+2,49+2,49+2,49+2,54+2,18+2,ST
15,144.0,2022.0,4-3-1-2,to_be_implemented,192563,GK,80,80,14000000.0,50000.0,30,190,83,13.0,Right,3,1,3,Medium/Medium,Lean (185+),False,False,False,False,False,False,False,False,False,False,False,False,False,False,False,False,False,False,False,False,False,False,False,False,False,False,False,False,False,False,False,False,False,False,False,False,False,False,False,False,False,False,False,False,,,,,,,9,9,13,50,10,16,9,8,48,35,55,56,52,75,44,56,73,43,70,14,28,25,7,56,23,62.0,27,15,18,82,78,74,79,82,55.0,32+3,32+3,32+3,32,34,34,34,32,38+3,38+3,38+3,35+3,40+3,40+3,40+3,35+3,33+3,38+3,38+3,38+3,33+3,33+3,33+3,33+3,33+3,33+3,79+1,GK,210625,RB|RWB,77,77,10000000.0,50000.0,27,184,83,13.0,Right,3,3,2,High/Medium,Normal (170-185),False,False,False,False,False,False,False,False,False,False,False,False,False,False,False,False,False,False,False,False,False,False,False,False,False,False,False,False,False,False,False,False,False,False,False,False,False,False,False,False,False,False,False,False,83.0,51.0,66.0,71.0,73.0,81.0,72,49,64,66,39,71,62,48,65,69,87,80,75,72,73,66,78,90,78,44,78,78,72,68,35,71.0,70,73,77,8,7,7,14,14,,66+2,66+2,66+2,69,68,68,68,69,68+2,68+2,68+2,71+2,69+2,69+2,69+2,71+2,75+2,73+2,73+2,73+2,75+2,75+2,73+2,73+2,73+2,75+2,17+2,RB,231633,LCB|CB,77,82,14000000.0,48000.0,25,194,92,13.0,Right,3,2,2,Medium/Medium,Lean (185+),False,False,False,False,False,False,False,False,False,False,False,False,False,False,False,False,False,False,False,False,False,False,False,False,False,False,False,False,False,False,False,False,False,False,False,False,False,False,False,False,False,False,False,False,62.0,36.0,52.0,56.0,78.0,78.0,37,30,76,67,48,50,32,34,63,62,54,69,52,73,47,50,74,63,85,31,79,79,42,43,44,70.0,77,79,78,10,7,6,14,9,,54+2,54+2,54+2,51,53,53,53,51,53+2,53+2,53+2,54+2,59+2,59+2,59+2,54+2,66+2,71+2,71+2,71+2,66+2,69+2,77+2,77+2,77+2,69+2,17+2,CB,222104,RCB|CB,75,82,10500000.0,38000.0,24,196,80,13.0,Right,3,2,1,Low/Medium,Lean (185+),False,False,False,False,False,False,False,False,False,False,False,False,False,False,False,False,False,False,False,False,False,False,False,False,False,False,False,False,False,False,False,False,False,False,False,False,False,False,False,False,False,False,False,False,72.0,31.0,57.0,58.0,75.0,77.0,38,30,71,73,25,50,30,22,71,66,66,76,53,71,53,36,77,68,82,28,75,74,28,51,35,76.0,75,77,74,14,11,11,8,9,,51+2,51+2,51+2,53,52,52,52,53,56+2,56+2,56+2,57+2,62+2,62+2,62+2,57+2,67+2,72+2,72+2,72+2,67+2,69+2,75+2,75+2,75+2,69+2,17+2,CB,201510,LB|LWB,75,75,4900000.0,57000.0,29,182,74,13.0,Left,3,3,2,High/Low,Lean (170-185),False,False,False,False,False,False,False,False,False,False,False,False,False,False,False,False,False,False,False,False,False,False,False,False,False,False,False,False,False,False,False,False,False,False,False,False,False,False,False,False,False,False,False,False,71.0,65.0,72.0,76.0,72.0,69.0,75,66,72,75,61,76,69,53,67,80,75,67,70,70,69,69,83,66,68,62,73,73,74,75,54,74.0,70,74,73,14,10,7,9,15,,71+2,71+2,71+2,73,73,73,73,73,73+2,73+2,73+2,74+1,73+2,73+2,73+2,74+1,73+2,72+2,72+2,72+2,73+2,73+2,73+2,73+2,73+2,73+2,18+2,LB,229391,CDM|CM,81,83,28500000.0,66000.0,26,190,85,13.0,Right,4,2,1,Medium/High,Normal (185+),False,False,False,False,False,False,False,False,False,False,False,False,False,False,False,False,False,False,False,False,False,False,False,False,False,False,False,False,False,False,False,False,False,False,False,False,False,False,False,False,False,False,False,False,63.0,65.0,70.0,72.0,82.0,89.0,59,62,79,76,54,74,61,45,78,75,62,63,60,77,44,76,81,87,90,64,89,80,67,71,56,82.0,83,84,83,14,10,8,7,7,,71+2,71+2,71+2,69,71,71,71,69,71+2,71+2,71+2,71+2,75+2,75+2,75+2,71+2,76+2,80+2,80+2,80+2,76+2,77+2,82+1,82+1,82+1,77+2,17+2,CDM,195202,CDM|CM,75,75,4600000.0,49000.0,31,186,84,13.0,Left,2,3,1,Medium/Low,Normal (185+),False,False,False,False,False,False,False,False,False,False,False,False,False,False,False,False,False,False,False,False,False,False,False,False,False,False,False,False,False,False,False,False,False,False,False,False,False,False,False,False,False,False,False,False,58.0,73.0,77.0,76.0,62.0,64.0,76,71,58,80,72,76,76,73,77,79,64,53,74,75,69,74,42,65,68,76,56,62,74,75,65,78.0,65,63,51,14,12,7,6,7,,71+2,71+2,71+2,74,74,74,74,74,75,75,75,74+1,75,75,75,74+1,67+2,69+2,69+2,69+2,67+2,65+2,63+2,63+2,63+2,65+2,17+2,CM,205990,CDM|CM,75,77,6000000.0,44000.0,27,175,72,13.0,Right,3,3,1,Medium/High,Normal (170-185),False,False,False,False,False,False,False,False,False,False,False,False,False,False,False,False,False,False,False,False,False,False,False,False,False,False,False,False,False,False,False,False,False,False,False,False,False,False,False,False,False,False,False,False,69.0,57.0,72.0,70.0,72.0,74.0,73,53,51,74,40,67,65,61,72,69,76,64,77,74,82,65,65,79,69,63,80,76,63,70,49,70.0,75,74,71,7,12,14,10,11,,63+2,63+2,63+2,68,66,66,66,68,69+2,69+2,69+2,69+2,71+2,71+2,71+2,69+2,73+2,74+2,74+2,74+2,73+2,72+2,71+2,71+2,71+2,72+2,17+2,CDM,208450,CAM|CF,76,79,10000000.0,51000.0,26,177,70,13.0,Right,4,4,1,Medium/Medium,Normal (170-185),False,False,False,False,False,False,False,False,False,False,False,False,False,False,False,False,False,False,False,False,False,False,False,False,False,False,False,False,False,False,False,False,False,False,False,False,False,False,False,False,False,False,False,False,76.0,74.0,77.0,78.0,65.0,68.0,77,69,56,76,72,79,81,78,76,78,77,75,79,74,77,81,65,77,60,78,79,67,71,76,70,70.0,67,66,63,15,14,7,10,7,,72+2,72+2,72+2,76,75,75,75,76,76+2,76+2,76+2,76+2,75+2,75+2,75+2,76+2,72+2,72+2,72+2,72+2,72+2,71+2,67+2,67+2,67+2,71+2,18+2,CAM,215716,CF|ST,78,78,15000000.0,63000.0,27,189,90,13.0,Right,4,3,1,High/Medium,Stocky (185+),False,False,False,False,False,False,False,False,False,False,False,False,False,False,False,False,False,False,False,False,False,False,False,False,False,False,False,False,False,False,False,False,False,False,False,False,False,False,False,False,False,False,False,False,64.0,79.0,57.0,71.0,27.0,87.0,29,81,81,71,78,67,51,52,50,77,61,67,65,78,63,82,84,76,91,70,89,14,82,70,74,75.0,25,24,13,15,12,6,7,13,,78,78,78,69,74,74,74,69,72+2,72+2,72+2,67+2,65+2,65+2,65+2,67+2,47+2,51+2,51+2,51+2,47+2,44+2,49+2,49+2,49+2,44+2,19+2,ST,244621,CF|ST,76,77,9000000.0,55000.0,27,190,83,13.0,Left,3,3,2,High/Medium,Normal (185+),False,False,False,False,False,False,False,False,False,False,False,False,False,False,False,False,False,False,False,False,False,False,False,False,False,False,False,False,False,False,False,False,False,False,False,False,False,False,False,False,False,False,False,False,71.0,76.0,61.0,73.0,41.0,79.0,51,78,70,71,73,73,65,48,47,77,66,75,66,75,44,83,52,76,83,68,81,41,77,65,71,80.0,44,33,25,15,13,13,7,6,,76+1,76+1,76+1,71,74,74,74,71,71+2,71+2,71+2,70+2,66+2,66+2,66+2,70+2,56+2,57+2,57+2,57+2,56+2,54+2,54+2,54+2,54+2,54+2,18+2,ST
16,14.0,2022.0,4-3-1-2,to_be_implemented,233306,GK,79,82,18000000.0,76000.0,25,188,85,13.0,Right,3,1,2,Medium/Medium,Normal (185+),False,False,False,False,False,False,False,False,False,False,False,False,False,False,False,False,False,False,False,False,False,False,False,False,False,False,False,False,False,False,False,False,False,False,False,False,False,False,False,False,False,False,False,False,,,,,,,14,9,13,45,5,13,13,10,48,35,55,56,61,77,56,58,68,32,64,6,35,11,8,55,16,60.0,15,14,14,80,78,77,75,82,55.0,31+2,31+2,31+2,32,33,33,33,32,37+2,37+2,37+2,34+2,37+2,37+2,37+2,34+2,29+2,34+2,34+2,34+2,29+2,29+2,28+2,28+2,28+2,29+2,78+2,GK,197853,RB|RWB,78,78,12500000.0,59000.0,29,174,74,13.0,Right,3,3,2,High/Medium,Stocky (170-185),False,False,False,False,False,False,False,False,False,False,False,False,False,False,False,False,False,False,False,False,False,False,False,False,False,False,False,False,False,False,False,False,False,False,False,False,False,False,False,False,False,False,False,False,73.0,62.0,74.0,74.0,75.0,75.0,80,58,78,81,61,73,69,36,71,77,74,73,68,76,76,76,88,70,72,55,86,75,68,71,64,73.0,74,75,77,7,10,15,16,9,,71+2,71+2,71+2,72,72,72,72,72,72+2,72+2,72+2,74+2,73+2,73+2,73+2,74+2,76+2,76+2,76+2,76+2,76+2,76+2,77+1,77+1,77+1,76+2,18+2,RB,202750,LCB|CB,78,78,9500000.0,57000.0,31,195,97,13.0,Right,4,2,1,Medium/Medium,Normal (185+),False,False,False,False,False,False,False,False,False,False,False,False,False,False,False,False,False,False,False,False,False,False,False,False,False,False,False,False,False,False,False,False,False,False,False,False,False,False,False,False,False,False,False,False,58.0,36.0,64.0,63.0,77.0,79.0,50,32,79,75,23,61,46,35,74,69,51,64,51,71,47,52,79,59,91,23,75,76,45,61,56,79.0,75,80,76,7,8,15,10,9,,56+2,56+2,56+2,56,57,57,57,56,60+2,60+2,60+2,60+2,66+2,66+2,66+2,60+2,68+2,74+2,74+2,74+2,68+2,70+2,78,78,78,70+2,16+2,CB,225859,RCB|CB,78,80,15500000.0,57000.0,26,190,85,13.0,Left,3,2,2,Medium/High,Normal (185+),False,False,False,False,False,False,False,False,False,False,False,False,False,False,False,False,False,False,False,False,False,False,False,False,False,False,False,False,False,False,False,False,False,False,False,False,False,False,False,False,False,False,False,False,79.0,42.0,65.0,67.0,79.0,78.0,66,37,81,73,39,69,41,36,70,65,69,87,66,77,52,49,77,69,83,38,79,79,49,58,74,73.0,77,81,75,9,14,6,8,7,,60+2,60+2,60+2,63,61,61,61,63,63+2,63+2,63+2,66+2,66+2,66+2,66+2,66+2,74+2,74+2,74+2,74+2,74+2,75+2,78+2,78+2,78+2,75+2,17+2,CB,251573,LB|LWB,80,85,29500000.0,46000.0,24,173,68,13.0,Left,3,4,1,High/Medium,Lean (170-185),False,False,False,False,False,False,False,False,False,False,False,False,False,False,False,False,False,False,False,False,False,False,False,False,False,False,False,False,False,False,False,False,False,False,False,False,False,False,False,False,False,False,False,False,83.0,68.0,76.0,80.0,74.0,75.0,81,66,70,78,59,80,81,57,75,80,83,83,84,80,82,76,78,84,69,68,78,74,74,73,55,78.0,73,76,79,12,7,11,10,15,,74+2,74+2,74+2,78,76,76,76,78,77+2,77+2,77+2,78+2,77+2,77+2,77+2,78+2,79+2,77+2,77+2,77+2,79+2,78+2,75+2,75+2,75+2,78+2,19+2,LB,202024,CDM|CM,80,80,20000000.0,72000.0,30,181,80,13.0,Right,3,4,2,Medium/Medium,Normal (170-185),False,False,False,False,False,False,False,False,False,False,False,False,False,False,False,False,False,False,False,False,False,False,False,False,False,False,False,False,False,False,False,False,False,False,False,False,False,False,False,False,False,False,False,False,68.0,71.0,75.0,78.0,75.0,74.0,63,68,41,81,68,78,60,70,80,80,67,69,69,83,64,73,55,89,69,75,72,79,78,79,61,83.0,80,79,73,12,8,9,14,13,,71+2,71+2,71+2,75,76,76,76,75,78+2,78+2,78+2,76+2,80,80,80,76+2,77+2,79+1,79+1,79+1,77+2,75+2,73+2,73+2,73+2,75+2,19+2,CM,186801,CDM|CM,77,77,7000000.0,53000.0,32,189,83,13.0,Right,3,3,2,High/High,Lean (185+),False,False,False,False,False,False,False,False,False,False,False,False,False,False,False,False,False,False,False,False,False,False,False,False,False,False,False,False,False,False,False,False,False,False,False,False,False,False,False,False,False,False,False,False,60.0,64.0,63.0,69.0,77.0,84.0,53,63,75,70,50,68,39,47,66,73,53,65,60,79,54,74,75,84,85,63,85,77,69,68,52,72.0,77,79,74,15,8,9,12,9,,70+2,70+2,70+2,66,69,69,69,66,68+2,68+2,68+2,67+2,71+2,71+2,71+2,67+2,72+2,76+1,76+1,76+1,72+2,72+2,77,77,77,72+2,18+2,CDM,234078,CDM|CM,75,80,8500000.0,45000.0,24,178,80,13.0,Right,3,3,2,Medium/Medium,Normal (170-185),False,False,False,False,False,False,False,False,False,False,False,False,False,False,False,False,False,False,False,False,False,False,False,False,False,False,False,False,False,False,False,False,False,False,False,False,False,False,False,False,False,False,False,False,64.0,54.0,71.0,82.0,70.0,72.0,61,43,51,78,50,83,65,50,73,82,76,55,79,78,85,66,67,77,70,68,71,72,64,76,42,80.0,76,70,70,7,6,7,7,10,,64+2,64+2,64+2,71,71,71,71,71,74+2,74+2,74+2,72+2,75+2,75+2,75+2,72+2,73+2,75+2,75+2,75+2,73+2,71+2,70+2,70+2,70+2,71+2,15+2,CM,207494,CAM|CF,78,78,14000000.0,65000.0,29,175,60,13.0,Right,3,4,2,High/Medium,Lean (170-185),False,False,False,False,False,False,False,False,False,False,False,False,False,False,False,False,False,False,False,False,False,False,False,False,False,False,False,False,False,False,False,False,False,False,False,False,False,False,False,False,False,False,False,False,75.0,77.0,73.0,79.0,57.0,65.0,70,76,63,77,76,80,79,64,62,78,77,74,78,78,84,78,65,74,58,79,72,51,82,78,70,77.0,63,57,49,14,10,8,13,9,,76+2,76+2,76+2,77,78,78,78,77,78,78,78,76+2,73+2,73+2,73+2,76+2,67+2,66+2,66+2,66+2,67+2,65+2,61+2,61+2,61+2,65+2,19+2,CAM,230978,CF|ST,77,80,14500000.0,56000.0,24,183,85,13.0,Right,2,3,1,High/Medium,Stocky (170-185),False,False,False,False,False,False,False,False,False,False,False,False,False,False,False,False,False,False,False,False,False,False,False,False,False,False,False,False,False,False,False,False,False,False,False,False,False,False,False,False,False,False,False,False,83.0,76.0,59.0,70.0,32.0,80.0,57,78,76,69,68,71,55,35,56,70,79,86,69,77,70,82,81,73,84,69,77,33,77,53,70,63.0,25,27,23,10,7,9,8,10,,77+2,77+2,77+2,71,73,73,73,71,69+2,69+2,69+2,70+2,63+2,63+2,63+2,70+2,54+2,53+2,53+2,53+2,54+2,52+2,50+2,50+2,50+2,52+2,16+2,ST,239015,CF|ST,76,80,11000000.0,52000.0,24,175,66,13.0,Right,3,4,1,Medium/Low,Normal (170-185),False,False,False,False,False,False,False,False,False,False,False,False,False,False,False,False,False,False,False,False,False,False,False,False,False,False,False,False,False,False,False,False,False,False,False,False,False,False,False,False,False,False,False,False,87.0,75.0,62.0,77.0,38.0,71.0,67,77,75,65,69,76,62,62,58,75,90,85,90,79,80,82,94,71,70,68,68,13,75,54,56,69.0,38,45,27,13,7,11,11,13,,76+2,76+2,76+2,75,74,74,74,75,71+2,71+2,71+2,73+2,64+2,64+2,64+2,73+2,56+2,53+2,53+2,53+2,56+2,55+2,51+2,51+2,51+2,55+2,18+2,ST
17,8.0,2022.0,4-3-2-1,to_be_implemented,242656,GK,77,84,18500000.0,25000.0,22,196,74,13.0,Left,3,1,1,Medium/Medium,Lean (185+),False,False,False,False,False,False,False,False,False,False,False,False,False,False,False,False,False,False,False,False,False,False,False,False,False,False,False,False,False,False,False,False,False,False,False,False,False,False,False,False,False,False,False,False,,,,,,,18,11,15,50,9,20,12,10,50,35,37,40,42,73,25,55,42,40,53,17,27,19,8,61,11,69.0,22,17,19,79,76,73,72,81,38.0,30+2,30+2,30+2,32,34,34,34,32,38+2,38+2,38+2,35+2,41+2,41+2,41+2,35+2,32+2,37+2,37+2,37+2,32+2,30+2,29+2,29+2,29+2,30+2,76+2,GK,233301,RB|RWB,77,82,15000000.0,31000.0,24,187,70,13.0,Right,4,3,1,High/High,Normal (185+),False,False,False,False,False,False,False,False,False,False,False,False,False,False,False,False,False,False,False,False,False,False,False,False,False,False,False,False,False,False,False,False,False,False,False,False,False,False,False,False,False,False,False,False,80.0,67.0,71.0,72.0,73.0,82.0,74,64,73,73,63,72,70,56,71,71,77,82,72,75,69,75,83,92,78,66,78,73,70,68,62,72.0,75,73,71,10,9,9,6,10,,72+2,72+2,72+2,72,71,71,71,72,71+2,71+2,71+2,73+2,72+2,72+2,72+2,73+2,76+2,74+2,74+2,74+2,76+2,75+2,74+2,74+2,74+2,75+2,16+2,RB,189456,LCB|CB,76,76,6000000.0,34000.0,30,187,73,13.0,Left,2,2,1,Low/High,Lean (185+),False,False,False,False,False,False,False,False,False,False,False,False,False,False,False,False,False,False,False,False,False,False,False,False,False,False,False,False,False,False,False,False,False,False,False,False,False,False,False,False,False,False,False,False,49.0,35.0,56.0,58.0,77.0,77.0,45,26,74,72,33,53,31,26,65,62,47,50,55,73,61,52,80,67,80,38,79,77,39,47,34,68.0,76,78,77,10,12,10,9,15,,52+2,52+2,52+2,51,52,52,52,51,54+2,54+2,54+2,54+2,61+2,61+2,61+2,54+2,66+2,72+2,72+2,72+2,66+2,68+2,76,76,76,68+2,18+2,CB,212602,RCB|CB,76,77,7000000.0,36000.0,28,186,76,13.0,Right,3,2,2,Medium/High,Lean (185+),False,False,False,False,False,False,False,False,False,False,False,False,False,False,False,False,False,False,False,False,False,False,False,False,False,False,False,False,False,False,False,False,False,False,False,False,False,False,False,False,False,False,False,False,67.0,40.0,63.0,68.0,75.0,78.0,55,39,74,75,31,65,30,35,72,76,67,67,61,73,62,45,80,69,79,37,86,80,43,60,53,70.0,71,76,76,8,12,11,9,7,,58+2,58+2,58+2,61,60,60,60,61,63+2,63+2,63+2,64+2,68+2,68+2,68+2,64+2,71+2,75+2,75+2,75+2,71+2,72+2,76+1,76+1,76+1,72+2,16+2,CB,241184,LB|LWB,75,78,7000000.0,31000.0,25,184,78,13.0,Left,3,3,2,Medium/Medium,Lean (170-185),False,False,False,False,False,False,False,False,False,False,False,False,False,False,False,False,False,False,False,False,False,False,False,False,False,False,False,False,False,False,False,False,False,False,False,False,False,False,False,False,False,False,False,False,75.0,62.0,70.0,71.0,72.0,75.0,76,62,71,74,55,74,65,43,68,72,74,76,62,72,60,68,72,77,74,59,76,74,72,64,42,70.0,67,74,73,7,7,7,14,14,,70+2,70+2,70+2,71,70,70,70,71,70+2,70+2,70+2,72+2,71+2,71+2,71+2,72+2,74+2,72+2,72+2,72+2,74+2,73+2,73+2,73+2,73+2,73+2,17+2,LB,232999,CDM|CM,76,80,10000000.0,29000.0,23,175,72,13.0,Right,3,3,2,High/High,Normal (170-185),False,False,False,False,False,False,False,False,False,False,False,False,False,False,False,False,False,False,False,False,False,False,False,False,False,False,False,False,False,False,False,False,False,False,False,False,False,False,False,False,False,False,False,False,80.0,48.0,69.0,73.0,73.0,76.0,55,48,65,79,33,70,52,42,74,72,86,75,83,77,85,51,84,86,68,46,79,74,65,72,51,76.0,73,77,70,6,13,12,8,7,,64+2,64+2,64+2,69,68,68,68,69,71+2,71+2,71+2,71+2,73+2,73+2,73+2,71+2,74+2,75+2,75+2,75+2,74+2,74+2,73+2,73+2,73+2,74+2,16+2,CDM,235945,CDM|CM,76,79,9000000.0,33000.0,25,184,77,13.0,Left,3,3,1,Medium/Medium,Lean (170-185),False,False,False,False,False,False,False,False,False,False,False,False,False,False,False,False,False,False,False,False,False,False,False,False,False,False,False,False,False,False,False,False,False,False,False,False,False,False,False,False,False,False,False,False,45.0,62.0,76.0,72.0,70.0,67.0,65,59,42,81,44,72,66,52,85,76,48,42,68,70,65,66,57,70,66,68,69,74,60,80,68,74.0,73,72,71,12,11,11,10,8,,62+2,62+2,62+2,67,67,67,67,67,71+2,71+2,71+2,69+2,76+2,76+2,76+2,69+2,69+2,75+2,75+2,75+2,69+2,68+2,68+2,68+2,68+2,68+2,17+2,CDM,203570,CDM|CM,75,75,4600000.0,36000.0,31,180,79,13.0,Right,4,3,1,High/High,Lean (170-185),False,False,False,False,False,False,False,False,False,False,False,False,False,False,False,False,False,False,False,False,False,False,False,False,False,False,False,False,False,False,False,False,False,False,False,False,False,False,False,False,False,False,False,False,70.0,70.0,71.0,74.0,73.0,76.0,66,71,63,76,59,74,57,50,71,75,68,71,72,75,69,70,57,92,73,72,68,74,72,74,57,75.0,74,74,73,13,7,11,13,7,,71+2,71+2,71+2,72,73,73,73,72,74+1,74+1,74+1,73+2,75,75,75,73+2,75,75,75,75,75,74+1,72+2,72+2,72+2,74+1,17+2,CM,198329,CAM|CF,77,77,8500000.0,40000.0,31,182,77,13.0,Left,3,4,3,High/Medium,Lean (170-185),False,False,False,False,False,False,False,False,False,False,False,False,False,False,False,False,False,False,False,False,False,False,False,False,False,False,False,False,False,False,False,False,False,False,False,False,False,False,False,False,False,False,False,False,77.0,77.0,76.0,78.0,45.0,69.0,77,75,76,79,75,79,83,67,65,79,77,77,77,78,74,84,75,75,67,76,64,33,77,78,77,78.0,46,43,38,7,13,10,11,5,,77,77,77,78-1,78-1,78-1,78-1,78-1,77,77,77,77,72+3,72+3,72+3,77,63+3,60+3,60+3,60+3,63+3,60+3,55+3,55+3,55+3,60+3,17+3,CAM,247361,CAM|CF,74,81,8500000.0,24000.0,21,176,66,13.0,Right,3,3,1,High/High,Lean (170-185),False,False,False,False,False,False,False,False,False,False,False,False,False,False,False,False,False,False,False,False,False,False,False,False,False,False,False,False,False,False,False,False,False,False,False,False,False,False,False,False,False,False,False,False,81.0,66.0,68.0,78.0,53.0,63.0,64,65,37,69,59,79,67,67,65,77,83,79,85,70,83,68,75,92,50,67,54,52,73,75,63,67.0,57,57,46,12,13,7,7,13,,67+2,67+2,67+2,74,73,73,73,74,74+2,74+2,74+2,74+2,71+2,71+2,71+2,74+2,67+2,64+2,64+2,64+2,67+2,64+2,55+2,55+2,55+2,64+2,18+2,CAM,206534,CF|ST,78,78,14500000.0,48000.0,28,185,71,13.0,Left,3,3,2,High/High,Lean (185+),False,False,False,False,False,False,False,False,False,False,False,False,False,False,False,False,False,False,False,False,False,False,False,False,False,False,False,False,False,False,False,False,False,False,False,False,False,False,False,False,False,False,False,False,82.0,78.0,68.0,73.0,42.0,77.0,59,82,75,73,69,70,68,59,63,78,75,87,67,80,66,80,68,89,76,69,65,47,83,74,74,77.0,50,27,20,9,7,11,6,16,,78,78,78,75,77,77,77,75,75+2,75+2,75+2,75+2,71+2,71+2,71+2,75+2,60+2,60+2,60+2,60+2,60+2,58+2,54+2,54+2,54+2,58+2,17+2,ST
18,1808.0,2022.0,4-3-1-2,to_be_implemented,228789,GK,77,83,13500000.0,37000.0,24,197,85,13.0,Right,4,1,1,Medium/Medium,Normal (185+),False,False,False,False,False,False,False,False,False,False,False,False,False,False,False,False,False,False,False,False,False,False,False,False,False,False,False,False,False,False,False,False,False,False,False,False,False,False,False,False,False,False,False,False,,,,,,,12,14,15,46,15,15,12,14,50,37,45,44,31,71,35,53,70,40,66,16,33,8,12,58,15,62.0,18,13,15,78,75,71,77,80,45.0,32+2,32+2,32+2,31,34,34,34,31,37+2,37+2,37+2,34+2,39+2,39+2,39+2,34+2,29+2,34+2,34+2,34+2,29+2,28+2,28+2,28+2,28+2,28+2,76+2,GK,242418,RB|RWB,75,83,12000000.0,35000.0,21,163,62,13.0,Right,3,2,1,High/Medium,Normal (170-),False,False,False,False,False,False,False,False,False,False,False,False,False,False,False,False,False,False,False,False,False,False,False,False,False,False,False,False,False,False,False,False,False,False,False,False,False,False,False,False,False,False,False,False,87.0,44.0,66.0,76.0,70.0,49.0,76,47,58,71,32,77,60,35,62,70,92,83,85,71,95,48,63,63,31,36,75,71,55,59,40,73.0,70,72,74,15,13,12,5,13,,59+2,59+2,59+2,69,65,65,65,69,66+2,66+2,66+2,70+2,65+2,65+2,65+2,70+2,73+2,68+2,68+2,68+2,73+2,73+2,66+2,66+2,66+2,73+2,18+2,RWB,199915,LCB|CB,79,79,14500000.0,65000.0,30,192,88,13.0,Right,3,2,1,Medium/High,Normal (185+),False,False,False,False,False,False,False,False,False,False,False,False,False,False,False,False,False,False,False,False,False,False,False,False,False,False,False,False,False,False,False,False,False,False,False,False,False,False,False,False,False,False,False,False,44.0,51.0,62.0,63.0,80.0,79.0,32,42,81,77,24,63,52,69,75,70,34,52,38,82,38,72,74,66,84,67,82,80,30,58,36,79.0,83,79,76,15,16,9,12,6,,59+2,59+2,59+2,55,59,59,59,55,61+2,61+2,61+2,57+2,68+2,68+2,68+2,57+2,67+2,77+2,77+2,77+2,67+2,69+2,79,79,79,69+2,20+2,CB,208004,RCB|CB,78,78,11500000.0,58000.0,30,184,75,13.0,Right,4,2,2,Medium/Medium,Normal (170-185),False,False,False,False,False,False,False,False,False,False,False,False,False,False,False,False,False,False,False,False,False,False,False,False,False,False,False,False,False,False,False,False,False,False,False,False,False,False,False,False,False,False,False,False,64.0,49.0,67.0,70.0,79.0,76.0,72,50,74,74,38,67,51,34,73,72,63,64,66,79,66,60,78,75,73,41,82,79,55,55,42,79.0,80,81,78,7,10,6,9,11,,63+2,63+2,63+2,65,63,63,63,65,64+2,64+2,64+2,67+2,69+2,69+2,69+2,67+2,75+2,76+2,76+2,76+2,75+2,75+2,78,78,78,75+2,17+2,CB,237942,LB|LWB,79,83,23500000.0,55000.0,24,175,78,13.0,Left,3,3,1,High/Medium,Stocky (170-185),False,False,False,False,False,False,False,False,False,False,False,False,False,False,False,False,False,False,False,False,False,False,False,False,False,False,False,False,False,False,False,False,False,False,False,False,False,False,False,False,False,False,False,False,81.0,46.0,69.0,72.0,75.0,76.0,79,48,75,79,38,73,59,36,62,71,80,82,74,74,73,41,72,79,75,42,74,75,52,56,69,65.0,69,80,79,14,7,14,7,7,,62+2,62+2,62+2,68,64,64,64,68,66+2,66+2,66+2,70+2,68+2,68+2,68+2,70+2,77+2,73+2,73+2,73+2,77+2,77+2,75+2,75+2,75+2,77+2,16+2,LB,190765,CDM|CM,77,77,8500000.0,60000.0,31,181,78,13.0,Right,4,4,2,Medium/Medium,Lean (170-185),False,False,False,False,False,False,False,False,False,False,False,False,False,False,False,False,False,False,False,False,False,False,False,False,False,False,False,False,False,False,False,False,False,False,False,False,False,False,False,False,False,False,False,False,50.0,74.0,81.0,75.0,58.0,72.0,84,72,53,81,65,75,85,77,79,78,55,45,66,79,67,76,71,83,68,80,67,58,75,80,72,81.0,56,60,59,8,15,15,16,11,,71+2,71+2,71+2,74,74,74,74,74,76+1,76+1,76+1,75+2,77,77,77,75+2,69+2,70+2,70+2,70+2,69+2,66+2,62+2,62+2,62+2,66+2,20+2,CM,243231,CDM|CM,76,82,12000000.0,49000.0,24,184,76,13.0,Right,3,3,1,High/High,Normal (170-185),False,False,False,False,False,False,False,False,False,False,False,False,False,False,False,False,False,False,False,False,False,False,False,False,False,False,False,False,False,False,False,False,False,False,False,False,False,False,False,False,False,False,False,False,82.0,75.0,72.0,75.0,72.0,78.0,66,74,61,77,71,77,66,58,72,75,78,85,75,75,65,79,73,85,75,78,78,74,75,76,59,76.0,72,74,70,15,7,12,14,8,,75+2,75+2,75+2,76,76,76,76,76,76+2,76+2,76+2,76+2,76+2,76+2,76+2,76+2,75+2,75+2,75+2,75+2,75+2,74+2,73+2,73+2,73+2,74+2,18+2,CM,180819,CDM|CM,75,75,2600000.0,53000.0,34,178,73,13.0,Right,5,4,2,High/Medium,Lean (170-185),False,False,False,False,False,False,False,False,False,False,False,False,False,False,False,False,False,False,False,False,False,False,False,False,False,False,False,False,False,False,False,False,False,False,False,False,False,False,False,False,False,False,False,False,61.0,70.0,77.0,77.0,62.0,61.0,74,70,64,80,72,77,77,66,76,80,68,55,70,75,75,72,68,54,60,69,71,64,73,80,70,80.0,61,63,60,6,15,14,8,11,,71+2,71+2,71+2,74,74,74,74,74,76-1,76-1,76-1,74+1,75,75,75,74+1,67+2,69+2,69+2,69+2,67+2,66+2,65+2,65+2,65+2,66+2,17+2,CM,239837,CAM|CF,76,82,12000000.0,49000.0,23,176,72,13.0,Right,3,3,1,Medium/Medium,Normal (170-185),False,False,False,False,False,False,False,False,False,False,False,False,False,False,False,False,False,False,False,False,False,False,False,False,False,False,False,False,False,False,False,False,False,False,False,False,False,False,False,False,False,False,False,False,69.0,77.0,78.0,75.0,56.0,62.0,79,77,61,77,73,75,83,81,76,78,73,66,71,74,72,76,64,68,63,80,51,45,77,77,77,74.0,65,54,51,7,10,14,15,10,,74+2,74+2,74+2,76,76,76,76,76,76+2,76+2,76+2,75+2,73+2,73+2,73+2,75+2,66+2,65+2,65+2,65+2,66+2,64+2,59+2,59+2,59+2,64+2,18+2,CAM,244176,CF|ST,77,80,14000000.0,63000.0,25,178,86,13.0,Right,5,3,1,Medium/Low,Stocky (170-185),False,False,False,False,False,False,False,False,False,False,False,False,False,False,False,False,False,False,False,False,False,False,False,False,False,False,False,False,False,False,False,False,False,False,False,False,False,False,False,False,False,False,False,False,68.0,80.0,71.0,75.0,32.0,76.0,67,82,66,72,80,74,74,66,62,78,69,67,68,74,82,78,66,70,81,77,73,18,83,78,74,80.0,25,37,29,9,12,9,11,13,,77+2,77+2,77+2,75,76,76,76,75,75+2,75+2,75+2,74+2,69+2,69+2,69+2,74+2,54+2,54+2,54+2,54+2,54+2,51+2,49+2,49+2,49+2,51+2,18+2,ST,186146,CF|ST,75,75,4800000.0,58000.0,31,185,73,13.0,Right,3,3,2,High/High,Normal (185+),False,False,False,False,False,False,False,False,False,False,False,False,False,False,False,False,False,False,False,False,False,False,False,False,False,False,False,False,False,False,False,False,False,False,False,False,False,False,False,False,False,False,False,False,70.0,73.0,67.0,74.0,42.0,66.0,69,76,78,66,69,75,61,62,64,78,67,73,67,72,61,77,79,50,70,63,75,32,78,70,71,77.0,43,38,33,9,10,6,12,16,,75,75,75,73,74,74,74,73,72+2,72+2,72+2,71+2,66+2,66+2,66+2,71+2,55+2,55+2,55+2,55+2,55+2,54+2,54+2,54+2,54+2,54+2,18+2,ST
19,1925.0,2022.0,3-5-2,to_be_implemented,212151,GK,78,81,14000000.0,37000.0,27,193,78,13.0,Right,2,1,1,Medium/Medium,Lean (185+),False,False,False,False,False,False,False,False,False,False,False,False,False,False,False,False,False,False,False,False,False,False,False,False,False,False,False,False,False,False,False,False,False,False,False,False,False,False,False,False,False,False,False,False,,,,,,,18,18,11,26,11,14,14,12,22,15,41,46,45,76,47,55,56,23,66,20,20,24,18,49,21,61.0,20,18,12,79,76,73,77,79,43.0,30+2,30+2,30+2,28,30,30,30,28,30+2,30+2,30+2,28+2,29+2,29+2,29+2,28+2,26+2,28+2,28+2,28+2,26+2,26+2,28+2,28+2,28+2,26+2,77+2,GK,189682,RCB|CB,78,78,9000000.0,46000.0,32,180,82,13.0,Left,3,2,1,Low/High,Normal (170-185),False,False,False,False,False,False,False,False,False,False,False,False,False,False,False,False,False,False,False,False,False,False,False,False,False,False,False,False,False,False,False,False,False,False,False,False,False,False,False,False,False,False,False,False,61.0,42.0,58.0,62.0,80.0,77.0,59,36,79,60,29,59,45,31,61,63,61,61,58,78,65,60,89,63,79,39,84,80,40,60,42,74.0,80,81,79,15,7,12,10,14,,56+2,56+2,56+2,56,56,56,56,56,57+2,57+2,57+2,59+2,62+2,62+2,62+2,59+2,69+2,72+2,72+2,72+2,69+2,72+2,78,78,78,72+2,19+2,CB,194201,CB,75,75,3800000.0,38000.0,31,194,86,13.0,Right,3,2,1,Medium/Medium,Normal (185+),False,False,False,False,False,False,False,False,False,False,False,False,False,False,False,False,False,False,False,False,False,False,False,False,False,False,False,False,False,False,False,False,False,False,False,False,False,False,False,False,False,False,False,False,53.0,42.0,54.0,62.0,75.0,79.0,29,29,71,69,41,60,49,40,62,67,50,55,53,75,35,68,56,67,86,50,80,74,28,50,39,75.0,77,76,73,9,5,14,6,7,,54+2,54+2,54+2,52,54,54,54,52,56+2,56+2,56+2,54+2,62+2,62+2,62+2,54+2,65+2,71+2,71+2,71+2,65+2,66+2,75,75,75,66+2,15+2,CB,224258,LCB|CB,75,83,11500000.0,33000.0,24,196,94,13.0,Right,3,3,1,High/High,Normal (185+),False,False,False,False,False,False,False,False,False,False,False,False,False,False,False,False,False,False,False,False,False,False,False,False,False,False,False,False,False,False,False,False,False,False,False,False,False,False,False,False,False,False,False,False,72.0,56.0,61.0,70.0,75.0,81.0,58,58,74,71,41,73,58,42,64,74,63,79,52,67,46,64,56,70,90,47,80,73,54,50,49,75.0,74,76,76,9,9,14,7,10,,66+2,66+2,66+2,65,65,65,65,65,64+2,64+2,64+2,66+2,66+2,66+2,66+2,66+2,71+2,72+2,72+2,72+2,71+2,72+2,75+2,75+2,75+2,72+2,15+2,CB,248808,RM|RWB|RB,75,85,12000000.0,28000.0,20,175,72,13.0,Right,5,2,1,High/High,Lean (170-185),False,False,False,False,False,False,False,False,False,False,False,False,False,False,False,False,False,False,False,False,False,False,False,False,False,False,False,False,False,False,False,False,False,False,False,False,False,False,False,False,False,False,False,False,77.0,55.0,69.0,73.0,70.0,58.0,72,48,62,73,56,74,62,40,69,75,79,75,74,69,64,64,64,81,51,61,47,67,59,67,48,72.0,70,74,73,13,14,8,13,5,,63+2,63+2,63+2,69,67,67,67,69,69+2,69+2,69+2,71+2,70+2,70+2,70+2,71+2,73+2,70+2,70+2,70+2,73+2,73+2,67+2,67+2,67+2,73+2,17+2,RB,210697,CDM|CM,76,76,6500000.0,42000.0,28,187,77,13.0,Right,3,3,1,Medium/High,Lean (185+),False,False,False,False,False,False,False,False,False,False,False,False,False,False,False,False,False,False,False,False,False,False,False,False,False,False,False,False,False,False,False,False,False,False,False,False,False,False,False,False,False,False,False,False,58.0,60.0,69.0,69.0,76.0,78.0,64,61,69,73,51,66,64,64,73,74,62,55,65,74,67,63,68,82,77,57,80,78,64,65,60,72.0,76,78,73,11,9,13,14,11,,66+2,66+2,66+2,66,66,66,66,66,68+2,68+2,68+2,68+2,71+2,71+2,71+2,68+2,72+2,75+1,75+1,75+1,72+2,72+2,75+1,75+1,75+1,72+2,18+2,CDM,229723,CDM|CM,74,77,5500000.0,39000.0,26,180,68,13.0,Right,4,3,1,Medium/High,Lean (170-185),False,False,False,False,False,False,False,False,False,False,False,False,False,False,False,False,False,False,False,False,False,False,False,False,False,False,False,False,False,False,False,False,False,False,False,False,False,False,False,False,False,False,False,False,67.0,62.0,76.0,72.0,67.0,71.0,77,59,50,76,50,69,72,68,77,74,69,66,77,74,77,62,67,78,68,67,70,72,69,78,69,79.0,72,68,60,5,13,10,8,12,,65+2,65+2,65+2,71,69,69,69,71,72+2,72+2,72+2,72+2,74+2,74+2,74+2,72+2,72+2,73+2,73+2,73+2,72+2,70+2,67+2,67+2,67+2,70+2,17+2,CM,235167,CDM|CM,74,80,6500000.0,34000.0,24,184,79,13.0,Left,3,3,1,High/High,Lean (170-185),False,False,False,False,False,False,False,False,False,False,False,False,False,False,False,False,False,False,False,False,False,False,False,False,False,False,False,False,False,False,False,False,False,False,False,False,False,False,False,False,False,False,False,False,68.0,69.0,71.0,72.0,73.0,78.0,68,67,55,75,72,72,48,54,76,74,69,67,68,75,70,76,72,81,78,69,76,75,71,73,52,75.0,74,76,72,6,8,6,6,14,,70+2,70+2,70+2,71,72,72,72,71,72+2,72+2,72+2,72+2,74+2,74+2,74+2,72+2,74+2,75+2,75+2,75+2,74+2,73+2,73+2,73+2,73+2,73+2,16+2,CM,241508,LM|LWB|LB,76,85,17000000.0,33000.0,21,180,71,13.0,Right,3,4,2,High/Low,Lean (170-185),False,False,False,False,False,False,False,False,False,False,False,False,False,False,False,False,False,False,False,False,False,False,False,False,False,False,False,False,False,False,False,False,False,False,False,False,False,False,False,False,False,False,False,False,84.0,68.0,71.0,81.0,48.0,62.0,63,70,51,73,48,82,66,82,70,80,90,79,91,68,87,71,72,71,56,72,64,45,72,76,47,74.0,52,46,40,6,10,14,11,7,,70+2,70+2,70+2,76,75,75,75,76,76+2,76+2,76+2,75+2,71+2,71+2,71+2,75+2,63+2,61+2,61+2,61+2,63+2,60+2,54+2,54+2,54+2,60+2,15+2,LM,212228,CF|ST,77,79,13000000.0,51000.0,26,187,76,13.0,Right,3,3,1,High/High,Normal (185+),False,False,False,False,False,False,False,False,False,False,False,False,False,False,False,False,False,False,False,False,False,False,False,False,False,False,False,False,False,False,False,False,False,False,False,False,False,False,False,False,False,False,False,False,78.0,77.0,64.0,73.0,49.0,82.0,54,80,78,70,76,70,61,64,56,76,75,81,78,77,70,77,89,79,83,67,82,49,79,69,89,78.0,41,48,42,16,8,8,7,8,,77+2,77+2,77+2,73,75,75,75,73,73+2,73+2,73+2,72+2,68+2,68+2,68+2,72+2,61+2,62+2,62+2,62+2,61+2,60+2,61+2,61+2,61+2,60+2,17+2,ST,260728,CF|ST,61,74,800000.0,6000.0,20,189,75,13.0,Right,3,2,1,Medium/Low,Normal (185+),False,False,False,False,False,False,False,False,False,False,False,False,False,False,False,False,False,False,False,False,False,False,False,False,False,False,False,False,False,False,False,False,False,False,False,False,False,False,False,False,False,False,False,False,70.0,59.0,44.0,58.0,23.0,68.0,31,64,59,52,54,57,36,43,31,60,68,72,54,58,57,57,68,59,74,50,66,18,63,53,58,58.0,17,21,20,9,12,8,7,6,,61+2,61+2,61+2,57,59,59,59,57,57+2,57+2,57+2,55+2,49+2,49+2,49+2,55+2,41+2,40+2,40+2,40+2,41+2,39+2,40+2,40+2,40+2,39+2,14+2,ST
20,1795.0,2022.0,3-5-2,to_be_implemented,257288,GK,73,82,6000000.0,21000.0,22,198,94,14.0,Right,3,1,1,Medium/Medium,Normal (185+),False,False,False,False,False,False,False,False,False,False,False,False,False,False,False,False,False,False,False,False,False,False,False,False,False,False,False,False,False,False,False,False,False,False,False,False,False,False,False,False,False,False,False,False,,,,,,,15,6,11,42,6,14,13,11,47,18,23,26,32,64,41,51,53,34,78,6,26,18,8,39,14,37.0,16,16,16,73,70,68,71,77,24.0,25+2,25+2,25+2,22,24,24,24,22,27+2,27+2,27+2,26+2,32+2,32+2,32+2,26+2,25+2,32+2,32+2,32+2,25+2,24+2,28+2,28+2,28+2,24+2,72+2,GK,210635,RCB|CB,75,77,6000000.0,58000.0,26,191,77,14.0,Left,2,2,1,Low/Medium,Normal (185+),False,False,False,False,False,False,False,False,False,False,False,False,False,False,False,False,False,False,False,False,False,False,False,False,False,False,False,False,False,False,False,False,False,False,False,False,False,False,False,False,False,False,False,False,59.0,45.0,60.0,59.0,74.0,78.0,58,35,75,69,31,54,36,26,65,67,53,64,53,69,53,70,87,58,88,50,78,72,32,56,40,60.0,74,74,72,15,16,14,10,14,,56+2,56+2,56+2,55,55,55,55,55,57+2,57+2,57+2,57+2,62+2,62+2,62+2,57+2,66+2,70+2,70+2,70+2,66+2,68+2,75+2,75+2,75+2,68+2,20+2,CB,190324,CB,74,74,2900000.0,34000.0,31,188,84,14.0,Right,3,2,1,Medium/High,Normal (185+),False,False,False,False,False,False,False,False,False,False,False,False,False,False,False,False,False,False,False,False,False,False,False,False,False,False,False,False,False,False,False,False,False,False,False,False,False,False,False,False,False,False,False,False,63.0,50.0,51.0,59.0,74.0,76.0,47,49,72,65,52,57,34,27,57,64,52,72,52,73,51,57,83,65,80,44,76,74,50,36,53,64.0,76,72,73,14,11,6,14,16,,60+2,60+2,60+2,56,57,57,57,56,56+2,56+2,56+2,57+2,59+2,59+2,59+2,57+2,66+2,68+2,68+2,68+2,66+2,68+2,74,74,74,68+2,20+2,CB,180706,LCB|CB,72,72,1100000.0,27000.0,33,190,83,14.0,Right,3,2,1,Medium/High,Lean (185+),False,False,False,False,False,False,False,False,False,False,False,False,False,False,False,False,False,False,False,False,False,False,False,False,False,False,False,False,False,False,False,False,False,False,False,False,False,False,False,False,False,False,False,False,35.0,37.0,55.0,53.0,74.0,71.0,39,29,76,67,30,47,39,39,64,58,34,35,49,72,50,56,67,57,77,41,73,73,33,52,28,71.0,77,73,72,8,6,12,9,13,,50+2,50+2,50+2,47,49,49,49,47,51+2,51+2,51+2,49+2,59+2,59+2,59+2,49+2,61+2,68+2,68+2,68+2,61+2,63+2,72,72,72,63+2,16+2,CB,192789,RM|RWB|RB,78,78,10000000.0,43000.0,31,180,77,14.0,Right,3,3,2,High/Medium,Normal (170-185),False,False,False,False,False,False,False,False,False,False,False,False,False,False,False,False,False,False,False,False,False,False,False,False,False,False,False,False,False,False,False,False,False,False,False,False,False,False,False,False,False,False,False,False,72.0,69.0,72.0,72.0,77.0,76.0,78,68,70,77,74,73,71,54,69,74,69,74,66,74,55,78,72,74,75,69,80,75,64,62,50,69.0,77,80,81,9,12,8,9,15,,71+2,71+2,71+2,71,71,71,71,71,70+2,70+2,70+2,72+2,72+2,72+2,72+2,72+2,76+2,75+2,75+2,75+2,76+2,76+2,76+2,76+2,76+2,76+2,18+2,RB,242794,CDM|CM,74,79,6500000.0,32000.0,23,178,65,14.0,Left,3,4,1,Medium/High,Lean (170-185),False,False,False,False,False,False,False,False,False,False,False,False,False,False,False,False,False,False,False,False,False,False,False,False,False,False,False,False,False,False,False,False,False,False,False,False,False,False,False,False,False,False,False,False,61.0,64.0,73.0,76.0,63.0,60.0,64,62,49,77,51,75,70,70,75,80,56,65,68,71,77,66,46,71,54,66,63,65,72,75,69,75.0,59,72,60,7,15,6,6,5,,66+2,66+2,66+2,71,71,71,71,71,73+2,73+2,73+2,71+2,74+2,74+2,74+2,71+2,68+2,70+2,70+2,70+2,68+2,66+2,63+2,63+2,63+2,66+2,15+2,CM,189725,CDM|CM,73,73,2400000.0,34000.0,32,175,67,14.0,Right,3,3,2,Medium/Medium,Normal (170-185),False,False,False,False,False,False,False,False,False,False,False,False,False,False,False,False,False,False,False,False,False,False,False,False,False,False,False,False,False,False,False,False,False,False,False,False,False,False,False,False,False,False,False,False,56.0,68.0,73.0,73.0,61.0,65.0,72,64,48,75,68,72,59,62,74,75,61,52,69,75,75,74,59,68,61,72,71,66,69,77,72,67.0,56,69,52,15,11,9,12,13,,67+2,67+2,67+2,70,70,70,70,70,72+1,72+1,72+1,70+2,73,73,73,70+2,66+2,69+2,69+2,69+2,66+2,64+2,63+2,63+2,63+2,64+2,19+2,CM,228332,CDM|CM,73,76,3800000.0,42000.0,24,178,64,14.0,Right,3,2,1,Medium/High,Lean (170-185),False,False,False,False,False,False,False,False,False,False,False,False,False,False,False,False,False,False,False,False,False,False,False,False,False,False,False,False,False,False,False,False,False,False,False,False,False,False,False,False,False,False,False,False,63.0,45.0,62.0,66.0,74.0,73.0,43,37,64,75,49,63,50,54,66,68,65,62,74,64,71,67,69,66,70,40,88,76,53,59,45,64.0,75,74,78,9,14,8,10,11,,58+2,58+2,58+2,59,60,60,60,59,62+2,62+2,62+2,61+2,65+2,65+2,65+2,61+2,68+2,72+2,72+2,72+2,68+2,69+2,73+2,73+2,73+2,69+2,17+2,CDM,220421,LM|LWB|LB,75,75,5000000.0,16000.0,28,168,67,14.0,Left,3,3,1,High/Medium,Normal (170-),False,False,False,False,False,False,False,False,False,False,False,False,False,False,False,False,False,False,False,False,False,False,False,False,False,False,False,False,False,False,False,False,False,False,False,False,False,False,False,False,False,False,False,False,84.0,59.0,68.0,75.0,70.0,75.0,71,57,55,72,47,74,66,41,68,71,86,83,83,71,92,68,66,80,73,57,77,73,68,66,46,74.0,70,72,74,8,9,16,9,13,,67+2,67+2,67+2,71,70,70,70,71,70+2,70+2,70+2,72+2,70+2,70+2,70+2,72+2,74+1,72+2,72+2,72+2,74+1,73+2,71+2,71+2,71+2,73+2,17+2,LB,230800,CF|ST,72,76,3300000.0,31000.0,25,182,76,14.0,Right,4,3,1,Medium/Medium,Normal (170-185),False,False,False,False,False,False,False,False,False,False,False,False,False,False,False,False,False,False,False,False,False,False,False,False,False,False,False,False,False,False,False,False,False,False,False,False,False,False,False,False,False,False,False,False,67.0,72.0,54.0,71.0,28.0,70.0,43,76,70,68,66,71,42,57,46,73,67,67,60,71,75,72,67,63,75,67,65,12,72,49,71,67.0,42,14,21,7,10,8,8,14,,72+2,72+2,72+2,67,69,69,69,67,66+2,66+2,66+2,65+2,58+2,58+2,58+2,65+2,47+2,47+2,47+2,47+2,47+2,45+2,44+2,44+2,44+2,45+2,16+2,ST,231743,CF|ST,72,77,3600000.0,45000.0,24,191,82,14.0,Left,2,3,1,Medium/Medium,Stocky (185+),False,False,False,False,False,False,False,False,False,False,False,False,False,False,False,False,False,False,False,False,False,False,False,False,False,False,False,False,False,False,False,False,False,False,False,False,False,False,False,False,False,False,False,False,69.0,69.0,54.0,72.0,43.0,82.0,47,72,74,63,64,73,49,40,40,75,66,72,65,67,66,72,72,65,93,63,80,44,70,58,60,67.0,44,38,23,7,14,9,9,5,,72+2,72+2,72+2,67,69,69,69,67,66+2,66+2,66+2,65+2,61+2,61+2,61+2,65+2,54+2,55+2,55+2,55+2,54+2,52+2,56+2,56+2,56+2,52+2,15+2,ST
21,12.0,2022.0,3-5-2,to_be_implemented,234777,GK,77,79,9500000.0,73000.0,27,191,86,14.0,Right,3,1,1,Medium/Medium,Stocky (185+),False,False,False,False,False,False,False,False,False,False,False,False,False,False,False,False,False,False,False,False,False,False,False,False,False,False,False,False,False,False,False,False,False,False,False,False,False,False,False,False,False,False,False,False,,,,,,,14,9,13,52,8,15,13,11,52,31,54,52,58,71,49,56,71,39,69,12,31,19,9,58,37,56.0,13,12,12,79,74,75,72,82,53.0,31+2,31+2,31+2,32,33,33,33,32,38+2,38+2,38+2,35+2,39+2,39+2,39+2,35+2,30+2,35+2,35+2,35+2,30+2,29+2,28+2,28+2,28+2,29+2,76+2,GK,211009,RCB|CB,73,75,3100000.0,22000.0,28,188,76,14.0,Right,3,2,1,Medium/High,Normal (185+),False,False,False,False,False,False,False,False,False,False,False,False,False,False,False,False,False,False,False,False,False,False,False,False,False,False,False,False,False,False,False,False,False,False,False,False,False,False,False,False,False,False,False,False,66.0,46.0,58.0,59.0,73.0,77.0,53,40,72,68,44,56,39,37,63,59,64,68,62,63,63,54,82,72,76,53,82,75,49,53,48,63.0,71,74,73,11,6,14,7,15,,57+2,57+2,57+2,57,56,56,56,57,58+2,58+2,58+2,59+2,61+2,61+2,61+2,59+2,67+2,69+2,69+2,69+2,67+2,68+2,73+2,73+2,73+2,68+2,16+2,CB,213697,CB,73,76,3500000.0,21000.0,27,183,72,14.0,Right,3,3,1,Medium/High,Normal (170-185),False,False,False,False,False,False,False,False,False,False,False,False,False,False,False,False,False,False,False,False,False,False,False,False,False,False,False,False,False,False,False,False,False,False,False,False,False,False,False,False,False,False,False,False,62.0,62.0,67.0,68.0,73.0,76.0,67,58,71,69,45,68,66,61,67,69,62,62,62,72,63,69,80,81,74,68,76,72,59,64,65,68.0,74,74,72,14,8,11,8,14,,65+2,65+2,65+2,65,66,66,66,65,66+2,66+2,66+2,67+2,69+2,69+2,69+2,67+2,71+2,72+2,72+2,72+2,71+2,71+2,73+2,73+2,73+2,71+2,18+2,CB,229682,LCB|CB,73,79,4400000.0,18000.0,24,191,72,14.0,Right,3,2,1,Medium/Medium,Lean (185+),False,False,False,False,False,False,False,False,False,False,False,False,False,False,False,False,False,False,False,False,False,False,False,False,False,False,False,False,False,False,False,False,False,False,False,False,False,False,False,False,False,False,False,False,64.0,29.0,56.0,59.0,74.0,72.0,54,25,73,64,26,57,35,22,56,65,61,66,36,74,62,40,82,68,76,25,66,75,29,58,36,70.0,76,72,72,10,8,12,14,7,,50+2,50+2,50+2,53,52,52,52,53,54+2,54+2,54+2,57+2,59+2,59+2,59+2,57+2,67+2,69+2,69+2,69+2,67+2,69+2,73+2,73+2,73+2,69+2,17+2,CB,253055,RM|RWB|RB,73,78,4300000.0,18000.0,23,176,71,14.0,Right,4,3,1,High/Medium,Lean (170-185),False,False,False,False,False,False,False,False,False,False,False,False,False,False,False,False,False,False,False,False,False,False,False,False,False,False,False,False,False,False,False,False,False,False,False,False,False,False,False,False,False,False,False,False,85.0,55.0,65.0,73.0,64.0,58.0,72,55,49,69,48,75,50,41,59,72,84,86,75,70,77,59,56,79,55,50,41,60,61,64,54,60.0,66,69,63,13,12,8,8,10,,63+2,63+2,63+2,70,67,67,67,70,68+2,68+2,68+2,71+2,67+2,67+2,67+2,71+2,71+2,65+2,65+2,65+2,71+2,69+2,62+2,62+2,62+2,69+2,17+2,RWB,213798,CDM|CM,72,72,2500000.0,24000.0,27,177,71,14.0,Left,2,3,1,Medium/Medium,Stocky (170-185),False,False,False,False,False,False,False,False,False,False,False,False,False,False,False,False,False,False,False,False,False,False,False,False,False,False,False,False,False,False,False,False,False,False,False,False,False,False,False,False,False,False,False,False,56.0,69.0,72.0,70.0,64.0,73.0,73,63,52,72,72,68,76,75,71,72,55,57,68,70,76,77,83,90,66,76,68,68,66,72,60,69.0,63,68,60,10,14,8,16,15,,66+2,66+2,66+2,68,68,68,68,68,69+2,69+2,69+2,69+2,72,72,72,69+2,69+2,70+2,70+2,70+2,69+2,67+2,65+2,65+2,65+2,67+2,20+2,CM,183422,CDM|CM,71,71,650000.0,17000.0,34,180,77,14.0,Right,3,3,1,Medium/High,Normal (170-185),False,False,False,False,False,False,False,False,False,False,False,False,False,False,False,False,False,False,False,False,False,False,False,False,False,False,False,False,False,False,False,False,False,False,False,False,False,False,False,False,False,False,False,False,54.0,68.0,67.0,68.0,68.0,71.0,63,63,60,68,71,66,66,61,67,71,57,52,62,70,69,78,72,85,66,72,68,67,64,69,63,73.0,71,70,67,16,9,12,11,12,,66+2,66+2,66+2,65,67,67,67,65,67+2,67+2,67+2,66+2,69+2,69+2,69+2,66+2,68+2,70+1,70+1,70+1,68+2,67+2,68+2,68+2,68+2,67+2,18+2,CDM,202693,CDM|CM,71,71,1900000.0,19000.0,28,192,80,14.0,Right,2,2,1,High/Medium,Normal (185+),False,False,False,False,False,False,False,False,False,False,False,False,False,False,False,False,False,False,False,False,False,False,False,False,False,False,False,False,False,False,False,False,False,False,False,False,False,False,False,False,False,False,False,False,67.0,67.0,64.0,68.0,68.0,80.0,45,69,68,72,55,69,54,52,69,70,66,67,64,70,50,69,34,86,83,67,77,66,68,70,58,65.0,66,72,65,8,15,7,8,6,,69+2,69+2,69+2,67,69,69,69,67,69+2,69+2,69+2,68+2,71,71,71,68+2,67+2,71,71,71,67+2,67+2,69+2,69+2,69+2,67+2,16+2,CM,243608,LM|LWB|LB,71,78,3600000.0,33000.0,22,183,72,14.0,Left,2,3,1,High/Medium,Lean (170-185),False,False,False,False,False,False,False,False,False,False,False,False,False,False,False,False,False,False,False,False,False,False,False,False,False,False,False,False,False,False,False,False,False,False,False,False,False,False,False,False,False,False,False,False,89.0,56.0,67.0,69.0,58.0,64.0,77,54,37,66,41,68,73,67,59,67,87,90,83,62,75,62,57,83,59,62,55,56,50,64,49,58.0,58,66,62,14,6,5,8,8,,59+2,59+2,59+2,68,64,64,64,68,65+2,65+2,65+2,69+2,64+2,64+2,64+2,69+2,69+2,63+2,63+2,63+2,69+2,67+2,59+2,59+2,59+2,67+2,15+2,LWB,213418,CF|ST,72,75,3100000.0,23000.0,26,186,81,14.0,Right,3,3,1,Medium/Low,Normal (185+),False,False,False,False,False,False,False,False,False,False,False,False,False,False,False,False,False,False,False,False,False,False,False,False,False,False,False,False,False,False,False,False,False,False,False,False,False,False,False,False,False,False,False,False,83.0,71.0,53.0,71.0,29.0,74.0,48,73,69,59,66,69,42,42,46,73,81,84,78,70,66,75,83,75,80,66,56,29,72,57,62,70.0,20,29,19,8,15,10,6,13,,72+2,72+2,72+2,69,70,70,70,69,67+2,67+2,67+2,67+2,60+2,60+2,60+2,67+2,51+2,48+2,48+2,48+2,51+2,49+2,46+2,46+2,46+2,49+2,17+2,ST,264337,CF|ST,70,81,3600000.0,23000.0,21,185,79,14.0,Right,3,3,1,Medium/Medium,Normal (185+),False,False,False,False,False,False,False,False,False,False,False,False,False,False,False,False,False,False,False,False,False,False,False,False,False,False,False,False,False,False,False,False,False,False,False,False,False,False,False,False,False,False,False,False,70.0,70.0,56.0,69.0,33.0,72.0,46,71,69,62,68,67,58,41,52,71,69,71,73,66,66,75,71,65,78,66,64,32,69,61,65,65.0,30,28,26,12,13,13,11,12,,70+2,70+2,70+2,66,68,68,68,66,66+2,66+2,66+2,64+2,60+2,60+2,60+2,64+2,50+2,50+2,50+2,50+2,50+2,48+2,48+2,48+2,48+2,48+2,18+2,ST
22,1792.0,2022.0,4-3-1-2,to_be_implemented,170597,GK,76,76,1300000.0,31000.0,34,188,74,14.0,Left,2,1,2,Medium/Medium,Lean (185+),False,False,False,False,False,False,False,False,False,False,False,False,False,False,False,False,False,False,False,False,False,False,False,False,False,False,False,False,False,False,False,False,False,False,False,False,False,False,False,False,False,False,False,False,,,,,,,13,11,19,31,16,13,13,15,45,25,40,35,44,72,42,53,74,36,63,14,36,15,8,50,20,52.0,14,17,14,75,73,71,75,79,38.0,28+2,28+2,28+2,26,28,28,28,26,30+2,30+2,30+2,29+2,33+2,33+2,33+2,29+2,26+2,31+2,31+2,31+2,26+2,26+2,28+2,28+2,28+2,26+2,75+1,GK,240060,RB|RWB,74,79,6000000.0,29000.0,22,171,69,14.0,Right,3,3,1,High/Medium,Normal (170-185),False,False,False,False,False,False,False,False,False,False,False,False,False,False,False,False,False,False,False,False,False,False,False,False,False,False,False,False,False,False,False,False,False,False,False,False,False,False,False,False,False,False,False,False,80.0,42.0,64.0,75.0,70.0,73.0,68,41,53,68,41,75,50,32,59,73,81,79,84,70,79,46,50,85,70,36,71,71,69,66,27,75.0,74,72,69,11,11,7,9,8,,60+2,60+2,60+2,68,65,65,65,68,67+2,67+2,67+2,70+2,68+2,68+2,68+2,70+2,73+2,70+2,70+2,70+2,73+2,72+2,69+2,69+2,69+2,72+2,16+2,RB,198904,LCB|CB,74,74,3500000.0,34000.0,30,187,81,14.0,Right,3,2,1,Medium/High,Normal (185+),False,False,False,False,False,False,False,False,False,False,False,False,False,False,False,False,False,False,False,False,False,False,False,False,False,False,False,False,False,False,False,False,False,False,False,False,False,False,False,False,False,False,False,False,53.0,32.0,47.0,49.0,76.0,78.0,29,30,72,60,32,43,33,35,63,54,52,54,44,71,51,40,84,65,82,29,81,76,29,39,26,66.0,78,74,75,9,9,11,12,8,,48+2,48+2,48+2,45,46,46,46,45,47+2,47+2,47+2,48+2,55+2,55+2,55+2,48+2,62+2,68+2,68+2,68+2,62+2,65+2,74,74,74,65+2,16+2,CB,200408,RCB|CB,70,70,1300000.0,22000.0,29,185,78,14.0,Left,3,2,1,Low/Medium,Normal (185+),False,False,False,False,False,False,False,False,False,False,False,False,False,False,False,False,False,False,False,False,False,False,False,False,False,False,False,False,False,False,False,False,False,False,False,False,False,False,False,False,False,False,False,False,50.0,27.0,48.0,46.0,71.0,76.0,29,24,72,62,20,40,38,22,57,50,52,48,47,58,60,35,78,67,82,22,73,70,27,44,48,55.0,70,73,71,12,8,16,16,11,,44+2,44+2,44+2,42,43,43,43,42,45+2,45+2,45+2,46+2,52+2,52+2,52+2,46+2,59+2,65+2,65+2,65+2,59+2,61+2,70,70,70,61+2,17+2,CB,236457,LB|LWB,73,74,3300000.0,31000.0,26,178,71,14.0,Left,2,3,1,High/Medium,Lean (170-185),False,False,False,False,False,False,False,False,False,False,False,False,False,False,False,False,False,False,False,False,False,False,False,False,False,False,False,False,False,False,False,False,False,False,False,False,False,False,False,False,False,False,False,False,81.0,42.0,63.0,71.0,68.0,66.0,70,32,60,67,44,70,69,40,54,71,79,83,76,66,75,68,65,77,60,33,66,72,64,60,39,65.0,65,71,71,14,5,13,9,12,,60+2,60+2,60+2,65,63,63,63,65,63+2,63+2,63+2,67+2,64+2,64+2,64+2,67+2,71+2,67+2,67+2,67+2,71+2,71+2,67+2,67+2,67+2,71+2,16+2,LB,206115,CDM|CM,75,76,6000000.0,61000.0,27,185,79,14.0,Right,4,2,1,Low/High,Normal (185+),False,False,False,False,False,False,False,False,False,False,False,False,False,False,False,False,False,False,False,False,False,False,False,False,False,False,False,False,False,False,False,False,False,False,False,False,False,False,False,False,False,False,False,False,54.0,60.0,63.0,70.0,75.0,77.0,43,53,67,74,35,71,45,43,69,74,55,54,54,75,60,75,71,76,77,66,81,74,69,71,45,72.0,76,76,74,9,15,8,8,12,,66+2,66+2,66+2,65,68,68,68,65,69+2,69+2,69+2,66+2,72+2,72+2,72+2,66+2,69+2,74+2,74+2,74+2,69+2,69+2,74+2,74+2,74+2,69+2,18+2,CDM,201368,CDM|CM,71,71,1800000.0,26000.0,30,183,70,14.0,Left,4,3,1,High/High,Normal (170-185),False,False,False,False,False,False,False,False,False,False,False,False,False,False,False,False,False,False,False,False,False,False,False,False,False,False,False,False,False,False,False,False,False,False,False,False,False,False,False,False,False,False,False,False,67.0,69.0,68.0,71.0,66.0,73.0,56,66,64,72,56,70,66,70,70,73,74,62,71,71,61,78,80,84,68,68,70,66,64,70,75,68.0,66,67,62,8,14,15,14,9,,69+2,69+2,69+2,68,70,70,70,68,70+1,70+1,70+1,69+2,71,71,71,69+2,68+2,70+1,70+1,70+1,68+2,67+2,67+2,67+2,67+2,67+2,18+2,CM,256051,CDM|CM,71,80,4200000.0,23000.0,22,173,70,14.0,Right,4,3,1,High/High,Normal (170-185),False,False,False,False,False,False,False,False,False,False,False,False,False,False,False,False,False,False,False,False,False,False,False,False,False,False,False,False,False,False,False,False,False,False,False,False,False,False,False,False,False,False,False,False,65.0,62.0,73.0,74.0,56.0,64.0,66,56,36,74,66,74,71,75,72,76,65,65,72,64,75,74,59,80,62,63,48,62,59,77,65,70.0,56,60,53,11,8,11,8,14,,63+2,63+2,63+2,68,68,68,68,68,70+2,70+2,70+2,70+2,71+2,71+2,71+2,70+2,66+2,66+2,66+2,66+2,66+2,63+2,58+2,58+2,58+2,63+2,16+2,CM,226401,CAM|CF,71,76,2800000.0,23000.0,24,185,70,14.0,Left,3,3,1,Medium/Low,Lean (185+),False,False,False,False,False,False,False,False,False,False,False,False,False,False,False,False,False,False,False,False,False,False,False,False,False,False,False,False,False,False,False,False,False,False,False,False,False,False,False,False,False,False,False,False,64.0,68.0,71.0,72.0,40.0,51.0,64,68,53,74,58,73,76,75,68,74,61,66,69,66,69,68,57,60,48,73,45,33,69,74,64,70.0,45,37,30,8,13,7,14,8,,66+2,66+2,66+2,70,70,70,70,70,71+2,71+2,71+2,69+2,67+2,67+2,67+2,69+2,55+2,55+2,55+2,55+2,55+2,52+2,46+2,46+2,46+2,52+2,17+2,CAM,190362,CF|ST,75,75,4600000.0,43000.0,32,180,80,14.0,Right,3,3,1,High/High,Normal (170-185),False,False,False,False,False,False,False,False,False,False,False,False,False,False,False,False,False,False,False,False,False,False,False,False,False,False,False,False,False,False,False,False,False,False,False,False,False,False,False,False,False,False,False,False,77.0,76.0,62.0,73.0,36.0,73.0,45,79,63,71,74,72,53,42,61,73,78,77,74,80,72,75,68,85,71,66,64,54,83,72,79,79.0,30,29,16,13,8,8,9,7,,75,75,75,72,75,75,75,72,74+1,74+1,74+1,72+2,69+2,69+2,69+2,72+2,57+2,58+2,58+2,58+2,57+2,53+2,50+2,50+2,50+2,53+2,17+2,ST,220862,CF|ST,69,69,1400000.0,21000.0,30,183,85,14.0,Right,3,3,1,High/High,Stocky (170-185),False,False,False,False,False,False,False,False,False,False,False,False,False,False,False,False,False,False,False,False,False,False,False,False,False,False,False,False,False,False,False,False,False,False,False,False,False,False,False,False,False,False,False,False,65.0,67.0,54.0,65.0,38.0,84.0,53,70,76,63,63,65,55,36,39,67,68,63,64,66,62,73,85,75,85,57,90,28,69,57,62,64.0,38,32,34,15,7,14,13,14,,69,69,69,64,66,66,66,64,63+2,63+2,63+2,63+2,58+2,58+2,58+2,63+2,52+2,52+2,52+2,52+2,52+2,51+2,53+2,53+2,53+2,51+2,18+2,ST
23,1796.0,2022.0,4-3-1-2,to_be_implemented,233164,GK,72,80,4500000.0,18000.0,23,197,81,14.0,Right,2,1,1,Medium/Medium,Normal (185+),False,False,False,False,False,False,False,False,False,False,False,False,False,False,False,False,False,False,False,False,False,False,False,False,False,False,False,False,False,False,False,False,False,False,False,False,False,False,False,False,False,False,False,False,,,,,,,13,12,10,41,16,18,18,11,43,26,44,46,38,57,40,55,62,29,68,14,24,18,11,52,18,60.0,15,12,13,72,71,73,73,74,45.0,29+2,29+2,29+2,28,30,30,30,28,33+2,33+2,33+2,31+2,33+2,33+2,33+2,31+2,26+2,30+2,30+2,30+2,26+2,25+2,26+2,26+2,26+2,25+2,71+2,GK,225147,RB|RWB,75,76,6000000.0,36000.0,26,175,76,14.0,Right,4,3,1,High/Medium,Normal (170-185),False,False,False,False,False,False,False,False,False,False,False,False,False,False,False,False,False,False,False,False,False,False,False,False,False,False,False,False,False,False,False,False,False,False,False,False,False,False,False,False,False,False,False,False,78.0,54.0,66.0,69.0,69.0,74.0,74,51,57,72,48,69,54,47,58,71,79,77,71,68,70,60,69,91,68,56,69,70,61,62,41,62.0,69,73,69,6,12,8,12,13,,63+2,63+2,63+2,68,66,66,66,68,66+2,66+2,66+2,70+2,68+2,68+2,68+2,70+2,74+2,70+2,70+2,70+2,74+2,73+2,69+2,69+2,69+2,73+2,17+2,RB,242660,LCB|CB,74,79,6000000.0,19000.0,22,187,80,14.0,Right,3,2,1,Medium/Medium,Normal (185+),False,False,False,False,False,False,False,False,False,False,False,False,False,False,False,False,False,False,False,False,False,False,False,False,False,False,False,False,False,False,False,False,False,False,False,False,False,False,False,False,False,False,False,False,73.0,34.0,59.0,66.0,75.0,69.0,61,29,71,69,31,63,40,35,57,70,72,73,69,68,64,46,83,61,70,30,75,74,48,53,42,72.0,75,77,76,7,7,13,11,11,,55+2,55+2,55+2,59,57,57,57,59,59+2,59+2,59+2,62+2,62+2,62+2,62+2,62+2,70+2,70+2,70+2,70+2,70+2,71+2,74+2,74+2,74+2,71+2,16+2,CB,194146,RCB|CB,70,70,1100000.0,21000.0,31,190,82,14.0,Right,2,2,1,Low/Medium,Normal (185+),False,False,False,False,False,False,False,False,False,False,False,False,False,False,False,False,False,False,False,False,False,False,False,False,False,False,False,False,False,False,False,False,False,False,False,False,False,False,False,False,False,False,False,False,51.0,35.0,50.0,56.0,70.0,69.0,38,29,73,60,26,53,38,32,55,58,52,50,55,66,49,56,79,43,78,27,75,69,48,50,32,66.0,70,71,70,8,14,7,8,7,,52+2,52+2,52+2,50,51,51,51,50,52+2,52+2,52+2,51+2,55+2,55+2,55+2,51+2,59+2,64+2,64+2,64+2,59+2,61+2,70,70,70,61+2,15+2,CB,204760,LB|LWB,75,75,5000000.0,38000.0,28,185,70,14.0,Left,2,3,1,High/High,Normal (185+),False,False,False,False,False,False,False,False,False,False,False,False,False,False,False,False,False,False,False,False,False,False,False,False,False,False,False,False,False,False,False,False,False,False,False,False,False,False,False,False,False,False,False,False,69.0,52.0,70.0,72.0,74.0,78.0,74,46,71,72,43,74,69,61,68,72,67,71,67,72,66,63,76,76,78,59,80,74,59,65,45,74.0,74,75,75,13,6,14,13,8,,64+2,64+2,64+2,67,66,66,66,67,67+2,67+2,67+2,69+2,69+2,69+2,69+2,69+2,73+2,73+2,73+2,73+2,73+2,73+2,75,75,75,73+2,17+2,LB,189280,CDM|CM,76,76,5000000.0,38000.0,32,175,73,14.0,Right,3,3,1,Medium/Medium,Normal (170-185),False,False,False,False,False,False,False,False,False,False,False,False,False,False,False,False,False,False,False,False,False,False,False,False,False,False,False,False,False,False,False,False,False,False,False,False,False,False,False,False,False,False,False,False,56.0,63.0,78.0,73.0,72.0,73.0,81,56,60,78,56,69,82,79,76,76,60,53,74,74,78,75,67,84,67,66,78,74,66,73,64,75.0,73,75,71,10,13,13,7,8,,66+2,66+2,66+2,69,69,69,69,69,71+2,71+2,71+2,71+2,74+2,74+2,74+2,71+2,74+2,75+1,75+1,75+1,74+2,73+2,72+2,72+2,72+2,73+2,17+2,CDM,220659,CDM|CM,75,78,7500000.0,40000.0,26,180,69,14.0,Right,3,3,1,Medium/High,Normal (170-185),False,False,False,False,False,False,False,False,False,False,False,False,False,False,False,False,False,False,False,False,False,False,False,False,False,False,False,False,False,False,False,False,False,False,False,False,False,False,False,False,False,False,False,False,67.0,65.0,71.0,74.0,75.0,78.0,65,61,67,74,54,73,63,70,73,76,71,64,70,77,71,76,84,89,71,71,78,82,69,71,46,72.0,72,77,68,8,11,12,7,9,,70+2,70+2,70+2,71,71,71,71,71,72+2,72+2,72+2,72+2,75+2,75+2,75+2,72+2,74+2,76+2,76+2,76+2,74+2,74+2,74+2,74+2,74+2,74+2,16+2,CM,228151,CDM|CM,75,78,6500000.0,36000.0,26,175,70,14.0,Right,3,3,1,Medium/High,Normal (170-185),False,False,False,False,False,False,False,False,False,False,False,False,False,False,False,False,False,False,False,False,False,False,False,False,False,False,False,False,False,False,False,False,False,False,False,False,False,False,False,False,False,False,False,False,68.0,56.0,73.0,71.0,72.0,71.0,73,48,60,77,48,68,63,55,75,73,71,65,72,74,78,68,70,85,65,63,71,75,59,69,58,70.0,73,74,72,9,12,15,11,9,,63+2,63+2,63+2,68,66,66,66,68,69+2,69+2,69+2,70+2,72+2,72+2,72+2,70+2,74+2,74+2,74+2,74+2,74+2,73+2,71+2,71+2,71+2,73+2,18+2,CDM,169792,CF|ST,74,74,3400000.0,40000.0,32,185,84,14.0,Right,4,3,2,High/Medium,Lean (185+),False,False,False,False,False,False,False,False,False,False,False,False,False,False,False,False,False,False,False,False,False,False,False,False,False,False,False,False,False,False,False,False,False,False,False,False,False,False,False,False,False,False,False,False,65.0,76.0,68.0,73.0,42.0,66.0,68,75,76,69,76,73,69,53,66,74,64,66,69,75,64,78,78,68,73,76,45,44,75,70,78,77.0,48,30,21,12,12,16,14,9,,74,74,74,72,73,73,73,72,72+2,72+2,72+2,71+2,68+2,68+2,68+2,71+2,57+2,56+2,56+2,56+2,57+2,54+2,52+2,52+2,52+2,54+2,19+2,ST,186905,CF|ST,72,72,1900000.0,32000.0,32,186,84,14.0,Right,4,3,1,High/High,Normal (185+),False,False,False,False,False,False,False,False,False,False,False,False,False,False,False,False,False,False,False,False,False,False,False,False,False,False,False,False,False,False,False,False,False,False,False,False,False,False,False,False,False,False,False,False,51.0,73.0,68.0,70.0,47.0,79.0,66,72,77,73,74,68,62,56,65,72,52,51,66,74,66,80,83,68,81,66,88,41,75,70,80,74.0,43,46,39,6,10,11,10,10,,72,72,72,68,70,70,70,68,70+2,70+2,70+2,68+2,68+2,68+2,68+2,68+2,57+2,61+2,61+2,61+2,57+2,56+2,59+2,59+2,59+2,56+2,16+2,ST,250807,CAM|CF,71,78,3800000.0,27000.0,22,183,76,14.0,Right,3,4,1,Medium/Low,Normal (170-185),False,False,False,False,False,False,False,False,False,False,False,False,False,False,False,False,False,False,False,False,False,False,False,False,False,False,False,False,False,False,False,False,False,False,False,False,False,False,False,False,False,False,False,False,75.0,70.0,64.0,73.0,36.0,65.0,52,72,60,73,64,74,61,63,50,76,76,75,74,65,60,70,54,69,67,67,58,24,74,74,62,68.0,34,37,34,9,12,6,9,13,,71+2,71+2,71+2,71,73,73,73,71,72+2,72+2,72+2,70+2,65+2,65+2,65+2,70+2,54+2,53+2,53+2,53+2,54+2,52+2,47+2,47+2,47+2,52+2,16+2,ST
24,109.0,2022.0,4-3-2-1,to_be_implemented,173533,GK,68,68,400000.0,10000.0,33,191,87,14.0,Right,3,1,1,Medium/Medium,Lean (185+),False,False,False,False,False,False,False,False,False,False,False,False,False,False,False,False,False,False,False,False,False,False,False,False,False,False,False,False,False,False,False,False,False,False,False,False,False,False,False,False,False,False,False,False,,,,,,,13,12,19,46,11,23,12,15,33,33,55,52,50,64,45,49,58,35,40,13,12,24,12,41,11,61.0,7,17,11,70,67,65,65,68,54.0,30+2,30+2,30+2,32,33,33,33,32,35+2,35+2,35+2,34+2,34+2,34+2,34+2,34+2,30+2,30+2,30+2,30+2,30+2,29+2,24+2,24+2,24+2,29+2,67+1,GK,223877,RB|RWB,72,75,2800000.0,22000.0,26,183,75,14.0,Right,3,3,1,Medium/Medium,Normal (170-185),False,False,False,False,False,False,False,False,False,False,False,False,False,False,False,False,False,False,False,False,False,False,False,False,False,False,False,False,False,False,False,False,False,False,False,False,False,False,False,False,False,False,False,False,74.0,36.0,60.0,69.0,69.0,72.0,69,35,72,61,30,68,48,36,57,72,72,76,71,68,68,36,81,79,67,30,71,68,63,60,49,63.0,69,69,70,14,13,11,9,8,,57+2,57+2,57+2,63,61,61,61,63,62+2,62+2,62+2,66+2,63+2,63+2,63+2,66+2,70+2,67+2,67+2,67+2,70+2,70+2,69+2,69+2,69+2,70+2,17+2,RWB,184037,LCB|CB,72,72,1500000.0,22000.0,32,191,77,14.0,Right,3,2,2,Low/Medium,Normal (185+),False,False,False,False,False,False,False,False,False,False,False,False,False,False,False,False,False,False,False,False,False,False,False,False,False,False,False,False,False,False,False,False,False,False,False,False,False,False,False,False,False,False,False,False,37.0,44.0,59.0,61.0,74.0,64.0,66,38,75,67,39,58,60,35,64,67,38,36,53,71,49,61,70,33,77,38,71,72,42,39,58,72.0,74,74,72,7,11,8,7,8,,55+2,55+2,55+2,53,53,53,53,53,54+2,54+2,54+2,54+2,58+2,58+2,58+2,54+2,63+2,67+2,67+2,67+2,63+2,64+2,72,72,72,64+2,15+2,CB,186158,RCB|CB,71,71,1300000.0,20000.0,31,194,94,14.0,Right,3,2,1,Medium/High,Normal (185+),False,False,False,False,False,False,False,False,False,False,False,False,False,False,False,False,False,False,False,False,False,False,False,False,False,False,False,False,False,False,False,False,False,False,False,False,False,False,False,False,False,False,False,False,53.0,29.0,49.0,49.0,71.0,81.0,39,26,71,64,23,44,33,34,53,57,52,53,34,67,38,43,59,70,89,20,80,71,35,38,40,66.0,73,71,67,6,10,14,10,7,,48+2,48+2,48+2,46,47,47,47,46,47+2,47+2,47+2,50+2,54+2,54+2,54+2,50+2,62+2,66+2,66+2,66+2,62+2,64+2,71,71,71,64+2,15+2,CB,178567,LB|LWB,71,71,975000.0,20000.0,33,183,87,14.0,Left,3,3,2,Medium/High,Normal (170-185),False,False,False,False,False,False,False,False,False,False,False,False,False,False,False,False,False,False,False,False,False,False,False,False,False,False,False,False,False,False,False,False,False,False,False,False,False,False,False,False,False,False,False,False,53.0,40.0,69.0,69.0,74.0,72.0,74,34,72,72,34,70,70,56,64,71,58,48,60,72,62,50,74,50,77,36,84,73,64,64,57,67.0,75,75,73,16,15,8,12,10,,58+2,58+2,58+2,63,61,61,61,63,63+2,63+2,63+2,64+2,66+2,66+2,66+2,64+2,69+2,71,71,71,69+2,69+2,74-3,74-3,74-3,69+2,19+2,LB,205201,CDM|CM,75,76,5500000.0,31000.0,28,191,79,14.0,Right,3,3,1,Medium/High,Lean (185+),False,False,False,False,False,False,False,False,False,False,False,False,False,False,False,False,False,False,False,False,False,False,False,False,False,False,False,False,False,False,False,False,False,False,False,False,False,False,False,False,False,False,False,False,59.0,70.0,70.0,70.0,73.0,81.0,67,65,78,73,70,70,72,60,72,74,58,60,61,70,59,79,68,81,83,75,80,74,68,70,60,71.0,71,72,70,12,16,10,13,7,,71+2,71+2,71+2,68,70,70,70,68,70+2,70+2,70+2,69+2,72+2,72+2,72+2,69+2,71+2,74+2,74+2,74+2,71+2,71+2,74+2,74+2,74+2,71+2,18+2,CDM,207928,CDM|CM,75,75,5500000.0,34000.0,29,188,88,14.0,Left,4,4,1,High/Medium,Normal (185+),False,False,False,False,False,False,False,False,False,False,False,False,False,False,False,False,False,False,False,False,False,False,False,False,False,False,False,False,False,False,False,False,False,False,False,False,False,False,False,False,False,False,False,False,70.0,70.0,74.0,80.0,58.0,73.0,61,66,51,78,66,82,76,62,75,81,72,69,72,72,83,75,51,72,81,76,58,59,76,80,56,77.0,60,61,48,12,11,13,12,11,,72+2,72+2,72+2,75,76-1,76-1,76-1,75,77-2,77-2,77-2,75,75,75,75,75,66+2,69+2,69+2,69+2,66+2,64+2,62+2,62+2,62+2,64+2,18+2,CM,189059,CDM|CM,71,71,1200000.0,20000.0,32,180,74,14.0,Right,2,3,1,Medium/Medium,Stocky (170-185),False,False,False,False,False,False,False,False,False,False,False,False,False,False,False,False,False,False,False,False,False,False,False,False,False,False,False,False,False,False,False,False,False,False,False,False,False,False,False,False,False,False,False,False,55.0,61.0,66.0,67.0,69.0,76.0,65,56,66,69,60,65,68,58,68,71,59,52,62,68,68,70,68,75,75,63,84,67,58,61,57,72.0,69,71,65,9,15,8,10,9,,64+2,64+2,64+2,63,64,64,64,63,64+2,64+2,64+2,65+2,67+2,67+2,67+2,65+2,67+2,70+1,70+1,70+1,67+2,67+2,70+1,70+1,70+1,67+2,17+2,CDM,205970,CAM|CF,75,75,5500000.0,34000.0,28,178,70,14.0,Right,4,4,1,High/Medium,Normal (170-185),False,False,False,False,False,False,False,False,False,False,False,False,False,False,False,False,False,False,False,False,False,False,False,False,False,False,False,False,False,False,False,False,False,False,False,False,False,False,False,False,False,False,False,False,77.0,72.0,74.0,75.0,45.0,67.0,74,73,49,74,61,76,68,73,70,75,78,76,80,74,74,70,68,87,61,72,58,40,73,77,71,65.0,45,49,43,12,14,14,11,6,,70+2,70+2,70+2,75,74,74,74,75,75,75,75,75,72+2,72+2,72+2,75,64+2,61+2,61+2,61+2,64+2,61+2,53+2,53+2,53+2,61+2,18+2,CAM,211506,CAM|CF,75,76,6500000.0,33000.0,27,182,73,14.0,Right,2,4,1,Medium/Low,Lean (170-185),False,False,False,False,False,False,False,False,False,False,False,False,False,False,False,False,False,False,False,False,False,False,False,False,False,False,False,False,False,False,False,False,False,False,False,False,False,False,False,False,False,False,False,False,64.0,74.0,75.0,78.0,58.0,58.0,68,72,52,76,67,77,76,76,77,79,67,61,83,65,77,84,49,62,67,73,32,61,71,78,70,75.0,55,60,60,14,7,10,7,9,,71+2,71+2,71+2,73,73,73,73,73,75+1,75+1,75+1,72+2,73+2,73+2,73+2,72+2,65+2,66+2,66+2,66+2,65+2,64+2,59+2,59+2,59+2,64+2,15+2,CAM,255043,CF|ST,71,82,4200000.0,21000.0,22,188,100,14.0,Right,4,2,1,High/Low,Stocky (185+),False,False,False,False,False,False,False,False,False,False,False,False,False,False,False,False,False,False,False,False,False,False,False,False,False,False,False,False,False,False,False,False,False,False,False,False,False,False,False,False,False,False,False,False,68.0,71.0,47.0,62.0,21.0,80.0,30,71,75,62,47,64,33,40,39,66,62,73,53,67,46,86,72,66,96,64,57,15,66,50,65,52.0,15,15,10,11,9,15,11,13,,71+2,71+2,71+2,61,66,66,66,61,62+2,62+2,62+2,60+2,55+2,55+2,55+2,60+2,42+2,42+2,42+2,42+2,42+2,40+2,41+2,41+2,41+2,40+2,17+2,ST
25,1952.0,2022.0,4-3-2-1,to_be_implemented,234803,GK,70,77,2700000.0,27000.0,23,189,88,14.0,Right,2,1,1,Medium/Medium,Normal (185+),False,False,False,False,False,False,False,False,False,False,False,False,False,False,False,False,False,False,False,False,False,False,False,False,False,False,False,False,False,False,False,False,False,False,False,False,False,False,False,False,False,False,False,False,,,,,,,14,11,13,30,10,14,12,14,31,31,37,46,28,58,31,50,60,31,52,12,25,12,7,46,11,42.0,12,13,12,70,69,66,72,70,41.0,26+2,26+2,26+2,26,28,28,28,26,29+2,29+2,29+2,28+2,29+2,29+2,29+2,28+2,24+2,26+2,26+2,26+2,24+2,24+2,23+2,23+2,23+2,24+2,69+2,GK,200778,RB|RWB,71,71,1600000.0,12000.0,29,188,82,14.0,Right,2,3,1,High/Medium,Normal (185+),False,False,False,False,False,False,False,False,False,False,False,False,False,False,False,False,False,False,False,False,False,False,False,False,False,False,False,False,False,False,False,False,False,False,False,False,False,False,False,False,False,False,False,False,79.0,53.0,63.0,68.0,65.0,76.0,66,48,64,67,41,71,60,35,60,67,75,83,70,63,56,66,67,82,75,51,71,64,68,62,49,60.0,61,70,66,11,15,7,12,10,,64+2,64+2,64+2,66,65,65,65,66,65+2,65+2,65+2,68+2,65+2,65+2,65+2,68+2,69+2,67+2,67+2,67+2,69+2,69+2,67+2,67+2,67+2,69+2,17+2,RB,212231,LCB|CB,69,70,1300000.0,9000.0,28,189,85,14.0,Right,3,2,1,Low/High,Lean (185+),False,False,False,False,False,False,False,False,False,False,False,False,False,False,False,False,False,False,False,False,False,False,False,False,False,False,False,False,False,False,False,False,False,False,False,False,False,False,False,False,False,False,False,False,59.0,30.0,47.0,54.0,67.0,77.0,34,22,70,57,22,54,24,29,55,55,55,62,48,65,48,60,74,55,83,21,89,65,25,48,36,63.0,68,67,67,12,9,12,7,11,,48+2,48+2,48+2,46,47,47,47,46,48+2,48+2,48+2,49+2,52+2,52+2,52+2,49+2,58+2,63+2,63+2,63+2,58+2,60+2,69+1,69+1,69+1,60+2,16+2,CB,248602,RCB|CB,69,78,2900000.0,6000.0,21,194,87,14.0,Left,2,2,1,High/Medium,Normal (185+),False,False,False,False,False,False,False,False,False,False,False,False,False,False,False,False,False,False,False,False,False,False,False,False,False,False,False,False,False,False,False,False,False,False,False,False,False,False,False,False,False,False,False,False,70.0,31.0,52.0,57.0,69.0,75.0,39,25,66,63,24,56,32,28,64,60,63,75,52,68,55,41,73,72,79,31,70,69,44,48,34,58.0,67,71,69,11,9,13,11,8,,51+2,51+2,51+2,52,52,52,52,52,54+2,54+2,54+2,56+2,59+2,59+2,59+2,56+2,64+2,67+2,67+2,67+2,64+2,65+2,69+2,69+2,69+2,65+2,16+2,CB,215412,LB|LWB,68,68,1200000.0,7000.0,27,181,78,14.0,Left,2,2,1,Medium/Medium,Normal (170-185),False,False,False,False,False,False,False,False,False,False,False,False,False,False,False,False,False,False,False,False,False,False,False,False,False,False,False,False,False,False,False,False,False,False,False,False,False,False,False,False,False,False,False,False,69.0,42.0,61.0,62.0,64.0,71.0,67,36,62,62,35,63,65,63,59,62,66,72,61,63,65,54,72,81,70,45,61,64,56,55,36,60.0,61,67,66,12,14,11,13,11,,56+2,56+2,56+2,59,58,58,58,59,58+2,58+2,58+2,62+2,61+2,61+2,61+2,62+2,66+2,64+2,64+2,64+2,66+2,66+2,65+2,65+2,65+2,66+2,18+2,LB,216451,CDM|CM,75,75,5500000.0,18000.0,30,171,74,14.0,Right,4,3,2,Medium/Medium,Normal (170-185),False,False,False,False,False,False,False,False,False,False,False,False,False,False,False,False,False,False,False,False,False,False,False,False,False,False,False,False,False,False,False,False,False,False,False,False,False,False,False,False,False,False,False,False,65.0,67.0,77.0,76.0,67.0,65.0,72,64,53,78,47,74,78,76,77,76,71,60,81,72,83,73,59,74,61,71,66,70,66,78,67,77.0,68,70,64,14,13,9,10,12,,67+2,67+2,67+2,72,71,71,71,72,74+1,74+1,74+1,73+2,75,75,75,73+2,71+2,72+2,72+2,72+2,71+2,69+2,66+2,66+2,66+2,69+2,19+2,CM,223154,CDM|CM,74,75,4800000.0,17000.0,27,185,88,14.0,Right,3,3,1,High/Medium,Normal (170-185),False,False,False,False,False,False,False,False,False,False,False,False,False,False,False,False,False,False,False,False,False,False,False,False,False,False,False,False,False,False,False,False,False,False,False,False,False,False,False,False,False,False,False,False,79.0,73.0,72.0,75.0,71.0,77.0,68,69,69,75,61,76,69,65,74,75,78,80,75,73,69,82,71,75,78,78,79,72,75,71,66,73.0,70,73,72,6,14,8,7,15,,74+1,74+1,74+1,74,75,75,75,74,74+1,74+1,74+1,74+1,74+1,74+1,74+1,74+1,73+2,74+1,74+1,74+1,73+2,73+2,73+2,73+2,73+2,73+2,17+2,CM,205818,CDM|CM,69,69,1200000.0,9000.0,28,174,72,14.0,Right,4,3,1,Low/High,Lean (170-185),False,False,False,False,False,False,False,False,False,False,False,False,False,False,False,False,False,False,False,False,False,False,False,False,False,False,False,False,False,False,False,False,False,False,False,False,False,False,False,False,False,False,False,False,67.0,54.0,67.0,70.0,64.0,68.0,65,49,48,69,57,67,57,55,74,69,67,67,85,66,87,58,81,86,57,59,70,65,58,64,49,69.0,66,67,65,15,12,11,7,15,,59+2,59+2,59+2,65,63,63,63,65,65+2,65+2,65+2,67+2,68+1,68+1,68+1,67+2,68+1,68+1,68+1,68+1,68+1,67+2,64+2,64+2,64+2,67+2,18+2,CDM,208053,CAM|CF,75,75,5500000.0,56000.0,28,175,73,14.0,Right,3,3,1,High/Medium,Lean (170-185),False,False,False,False,False,False,False,False,False,False,False,False,False,False,False,False,False,False,False,False,False,False,False,False,False,False,False,False,False,False,False,False,False,False,False,False,False,False,False,False,False,False,False,False,77.0,69.0,73.0,77.0,43.0,58.0,67,67,46,76,69,78,76,72,72,75,80,75,85,67,88,70,53,72,51,73,60,40,73,75,66,69.0,48,39,41,11,15,11,10,16,,68+2,68+2,68+2,74,73,73,73,74,75,75,75,74+1,70+2,70+2,70+2,74+1,61+2,59+2,59+2,59+2,61+2,57+2,50+2,50+2,50+2,57+2,19+2,CAM,225151,CAM|CF,72,73,2700000.0,14000.0,27,178,75,14.0,Left,5,4,1,High/Medium,Lean (170-185),False,False,False,False,False,False,False,False,False,False,False,False,False,False,False,False,False,False,False,False,False,False,False,False,False,False,False,False,False,False,False,False,False,False,False,False,False,False,False,False,False,False,False,False,78.0,62.0,73.0,75.0,61.0,67.0,71,57,58,75,56,76,73,71,72,75,78,78,79,70,69,71,70,67,68,68,65,63,70,71,53,68.0,60,61,58,8,11,9,9,13,,68+2,68+2,68+2,72,71,71,71,72,72+1,72+1,72+1,72+1,71+2,71+2,71+2,72+1,68+2,67+2,67+2,67+2,68+2,67+2,64+2,64+2,64+2,67+2,17+2,CAM,228761,CF|ST,73,76,4100000.0,16000.0,25,182,87,14.0,Left,2,3,1,Medium/Medium,Stocky (170-185),False,False,False,False,False,False,False,False,False,False,False,False,False,False,False,False,False,False,False,False,False,False,False,False,False,False,False,False,False,False,False,False,False,False,False,False,False,False,False,False,False,False,False,False,71.0,72.0,51.0,69.0,30.0,79.0,46,72,82,58,65,69,58,60,47,70,71,71,65,74,70,77,85,73,80,69,80,18,76,42,64,67.0,23,30,24,11,11,14,9,6,,73+2,73+2,73+2,66,69,69,69,66,64+2,64+2,64+2,64+2,58+2,58+2,58+2,64+2,49+2,48+2,48+2,48+2,49+2,47+2,48+2,48+2,48+2,47+2,17+2,ST
26,1794.0,2022.0,3-5-2,to_be_implemented,193182,GK,74,74,2200000.0,19000.0,31,185,75,14.0,Left,3,1,1,Medium/Medium,Normal (185+),False,False,False,False,False,False,False,False,False,False,False,False,False,False,False,False,False,False,False,False,False,False,False,False,False,False,False,False,False,False,False,False,False,False,False,False,False,False,False,False,False,False,False,False,,,,,,,21,13,20,49,13,12,20,14,46,28,46,40,62,68,42,54,58,34,71,15,30,19,12,60,14,53.0,12,20,11,74,71,72,73,76,44.0,31+2,31+2,31+2,31,32,32,32,31,36+2,36+2,36+2,33+2,38+2,38+2,38+2,33+2,29+2,34+2,34+2,34+2,29+2,28+2,29+2,29+2,29+2,28+2,73+1,GK,204936,RCB|CB,74,74,3500000.0,24000.0,29,185,75,14.0,Right,3,2,1,Low/Medium,Normal (185+),False,False,False,False,False,False,False,False,False,False,False,False,False,False,False,False,False,False,False,False,False,False,False,False,False,False,False,False,False,False,False,False,False,False,False,False,False,False,False,False,False,False,False,False,64.0,46.0,54.0,61.0,73.0,77.0,32,43,76,71,50,55,36,29,69,68,62,65,60,75,66,62,77,72,80,41,78,76,38,44,42,64.0,72,73,71,15,10,9,8,6,,59+2,59+2,59+2,55,57,57,57,55,58+2,58+2,58+2,57+2,63+2,63+2,63+2,57+2,66+2,72+2,72+2,72+2,66+2,68+2,74,74,74,68+2,17+2,CB,184274,CB,73,73,1500000.0,21000.0,33,190,80,14.0,Right,2,2,1,High/Medium,Lean (185+),False,False,False,False,False,False,False,False,False,False,False,False,False,False,False,False,False,False,False,False,False,False,False,False,False,False,False,False,False,False,False,False,False,False,False,False,False,False,False,False,False,False,False,False,53.0,43.0,61.0,63.0,74.0,76.0,63,37,73,67,52,63,48,30,62,64,51,54,55,73,54,59,67,66,79,40,83,73,50,57,31,62.0,74,74,73,14,15,6,7,6,,57+2,57+2,57+2,58,57,57,57,58,58+2,58+2,58+2,60+2,63+2,63+2,63+2,60+2,68+2,70+2,70+2,70+2,68+2,68+2,73,73,73,68+2,17+2,CB,183129,LCB|CB,72,72,1500000.0,46000.0,32,185,88,14.0,Left,2,2,2,Low/Medium,Normal (170-185),False,False,False,False,False,False,False,False,False,False,False,False,False,False,False,False,False,False,False,False,False,False,False,False,False,False,False,False,False,False,False,False,False,False,False,False,False,False,False,False,False,False,False,False,35.0,51.0,51.0,54.0,73.0,71.0,39,44,79,60,51,50,50,36,54,58,36,34,54,62,50,71,78,52,76,48,80,71,49,51,55,62.0,70,75,72,14,7,12,14,12,,56+2,56+2,56+2,49,53,53,53,49,52+2,52+2,52+2,50+2,57+2,57+2,57+2,50+2,58+2,65+2,65+2,65+2,58+2,61+2,72,72,72,61+2,17+2,CB,244591,RM|RWB|RB,73,81,6500000.0,15000.0,21,178,69,14.0,Right,3,3,1,High/Medium,Lean (170-185),False,False,False,False,False,False,False,False,False,False,False,False,False,False,False,False,False,False,False,False,False,False,False,False,False,False,False,False,False,False,False,False,False,False,False,False,False,False,False,False,False,False,False,False,81.0,55.0,67.0,73.0,68.0,67.0,72,55,55,70,34,73,60,38,65,72,81,81,76,66,73,61,71,72,65,51,67,69,74,66,44,71.0,67,72,69,15,10,11,7,6,,65+2,65+2,65+2,70,69,69,69,70,69+2,69+2,69+2,71+2,68+2,68+2,68+2,71+2,71+2,69+2,69+2,69+2,71+2,71+2,68+2,68+2,68+2,71+2,16+2,RWB,228092,CDM|CM,75,81,8000000.0,22000.0,24,195,96,14.0,Right,3,3,1,Medium/Medium,Normal (185+),False,False,False,False,False,False,False,False,False,False,False,False,False,False,False,False,False,False,False,False,False,False,False,False,False,False,False,False,False,False,False,False,False,False,False,False,False,False,False,False,False,False,False,False,64.0,62.0,71.0,72.0,73.0,83.0,65,60,79,76,48,75,71,50,74,75,55,72,56,72,54,75,73,79,91,59,72,73,68,73,54,83.0,73,74,66,14,9,10,8,10,,70+2,70+2,70+2,69,70,70,70,69,71+2,71+2,71+2,71+2,73+2,73+2,73+2,71+2,72+2,74+2,74+2,74+2,72+2,71+2,75+2,75+2,75+2,71+2,17+2,CDM,186143,CDM|CM,73,73,2100000.0,21000.0,31,175,69,14.0,Right,3,2,1,Medium/Medium,Lean (170-185),False,False,False,False,False,False,False,False,False,False,False,False,False,False,False,False,False,False,False,False,False,False,False,False,False,False,False,False,False,False,False,False,False,False,False,False,False,False,False,False,False,False,False,False,48.0,66.0,77.0,67.0,68.0,64.0,76,59,56,76,69,62,81,75,80,74,49,47,67,73,67,76,64,78,56,72,68,73,60,75,72,73.0,67,68,69,16,16,7,7,12,,64+2,64+2,64+2,66,66,66,66,66,69+2,69+2,69+2,68+2,73,73,73,68+2,70+2,72+1,72+1,72+1,70+2,69+2,67+2,67+2,67+2,69+2,19+2,CDM,189177,CDM|CM,73,73,2900000.0,23000.0,30,170,72,14.0,Left,2,3,1,Medium/High,Stocky (170-),False,False,False,False,False,False,False,False,False,False,False,False,False,False,False,False,False,False,False,False,False,False,False,False,False,False,False,False,False,False,False,False,False,False,False,False,False,False,False,False,False,False,False,False,65.0,69.0,74.0,74.0,66.0,73.0,75,65,44,75,79,71,78,70,73,74,66,64,79,71,84,78,79,83,64,71,79,69,67,72,60,74.0,71,67,68,7,8,7,13,6,,67+2,67+2,67+2,71,70,70,70,71,71+2,71+2,71+2,72+1,73,73,73,72+1,72+1,72+1,72+1,72+1,72+1,70+2,67+2,67+2,67+2,70+2,15+2,CM,210985,LM|LWB|LB,72,72,2300000.0,19000.0,27,176,75,14.0,Left,3,3,1,High/Medium,Normal (170-185),False,False,False,False,False,False,False,False,False,False,False,False,False,False,False,False,False,False,False,False,False,False,False,False,False,False,False,False,False,False,False,False,False,False,False,False,False,False,False,False,False,False,False,False,71.0,65.0,71.0,72.0,65.0,60.0,71,61,48,71,68,70,71,70,68,72,73,69,80,68,83,73,33,84,56,69,47,64,66,72,42,67.0,67,69,67,10,11,13,7,15,,65+2,65+2,65+2,70,69,69,69,70,70+2,70+2,70+2,70+2,70+2,70+2,70+2,70+2,70+2,68+2,68+2,68+2,70+2,69+2,62+2,62+2,62+2,69+2,17+2,LWB,163050,CF|ST,72,72,800000.0,17000.0,36,175,70,14.0,Right,3,2,1,Medium/Medium,Stocky (170-185),False,False,False,False,False,False,False,False,False,False,False,False,False,False,False,False,False,False,False,False,False,False,False,False,False,False,False,False,False,False,False,False,False,False,False,False,False,False,False,False,False,False,False,False,55.0,74.0,62.0,65.0,39.0,67.0,61,79,75,66,74,58,65,55,53,71,58,52,64,77,71,72,55,53,72,64,73,33,80,65,75,82.0,39,34,28,7,8,11,11,8,,72,72,72,67,69,69,69,67,67+2,67+2,67+2,65+2,62+2,62+2,62+2,65+2,51+2,53+2,53+2,53+2,51+2,50+2,51+2,51+2,51+2,50+2,16+2,ST,220031,CF|ST,70,73,2100000.0,17000.0,26,191,77,14.0,Right,3,3,1,Medium/Medium,Lean (185+),False,False,False,False,False,False,False,False,False,False,False,False,False,False,False,False,False,False,False,False,False,False,False,False,False,False,False,False,False,False,False,False,False,False,False,False,False,False,False,False,False,False,False,False,54.0,69.0,57.0,67.0,33.0,76.0,40,70,74,69,71,67,42,33,55,73,54,54,55,70,54,77,77,69,79,58,77,28,71,66,65,68.0,32,29,20,13,11,12,13,13,,70+2,70+2,70+2,64,68,68,68,64,67+2,67+2,67+2,64+2,63+2,63+2,63+2,64+2,48+2,52+2,52+2,52+2,48+2,46+2,49+2,49+2,49+2,46+2,19+2,ST
27,3.0,2022.0,4-3-1-2,to_be_implemented,188400,GK,73,74,2300000.0,27000.0,29,188,70,14.0,Right,3,1,1,Medium/Medium,Lean (185+),False,False,False,False,False,False,False,False,False,False,False,False,False,False,False,False,False,False,False,False,False,False,False,False,False,False,False,False,False,False,False,False,False,False,False,False,False,False,False,False,False,False,False,False,,,,,,,18,14,10,40,17,11,11,17,46,16,47,45,59,69,42,52,66,31,62,15,29,17,18,53,24,47.0,17,11,17,72,75,69,67,74,46.0,29+2,29+2,29+2,29,30,30,30,29,33+2,33+2,33+2,31+2,33+2,33+2,33+2,31+2,27+2,31+2,31+2,31+2,27+2,26+2,26+2,26+2,26+2,26+2,72+2,GK,232185,RB|RWB,69,74,2000000.0,15000.0,24,181,68,14.0,Right,4,3,1,High/Medium,Normal (170-185),False,False,False,False,False,False,False,False,False,False,False,False,False,False,False,False,False,False,False,False,False,False,False,False,False,False,False,False,False,False,False,False,False,False,False,False,False,False,False,False,False,False,False,False,80.0,51.0,60.0,68.0,64.0,64.0,67,50,52,64,42,68,51,48,56,66,78,81,79,64,73,50,59,75,64,53,52,64,56,52,50,54.0,65,67,62,10,8,14,11,15,,59+2,59+2,59+2,64,61,61,61,64,62+2,62+2,62+2,65+2,62+2,62+2,62+2,65+2,67+2,63+2,63+2,63+2,67+2,67+2,63+2,63+2,63+2,67+2,17+2,RWB,221281,LCB|CB,71,74,2200000.0,24000.0,26,188,70,14.0,Right,3,2,1,Medium/Medium,Lean (185+),False,False,False,False,False,False,False,False,False,False,False,False,False,False,False,False,False,False,False,False,False,False,False,False,False,False,False,False,False,False,False,False,False,False,False,False,False,False,False,False,False,False,False,False,54.0,32.0,53.0,58.0,72.0,74.0,41,23,72,64,35,52,45,26,59,65,52,55,56,69,50,54,79,73,76,28,68,72,31,48,31,65.0,72,72,68,10,11,10,15,8,,50+2,50+2,50+2,49,50,50,50,49,52+2,52+2,52+2,53+2,58+2,58+2,58+2,53+2,64+2,68+2,68+2,68+2,64+2,65+2,71+2,71+2,71+2,65+2,17+2,CB,231540,RCB|CB,71,76,2600000.0,21000.0,24,182,78,14.0,Left,3,2,1,Low/High,Normal (170-185),False,False,False,False,False,False,False,False,False,False,False,False,False,False,False,False,False,False,False,False,False,False,False,False,False,False,False,False,False,False,False,False,False,False,False,False,False,False,False,False,False,False,False,False,63.0,32.0,50.0,62.0,70.0,77.0,32,30,73,65,32,60,31,28,64,63,65,61,61,66,60,36,83,70,81,31,72,64,33,43,38,64.0,70,71,71,15,13,11,11,10,,51+2,51+2,51+2,52,51,51,51,52,54+2,54+2,54+2,55+2,58+2,58+2,58+2,55+2,62+2,67+2,67+2,67+2,62+2,64+2,71+2,71+2,71+2,64+2,18+2,CB,235770,LB|LWB,69,75,2100000.0,15000.0,23,183,78,14.0,Left,2,2,1,High/Medium,Lean (170-185),False,False,False,False,False,False,False,False,False,False,False,False,False,False,False,False,False,False,False,False,False,False,False,False,False,False,False,False,False,False,False,False,False,False,False,False,False,False,False,False,False,False,False,False,74.0,51.0,64.0,65.0,64.0,70.0,68,45,55,63,38,65,66,63,60,63,75,73,72,64,69,61,65,82,71,57,56,65,61,65,47,62.0,66,64,63,11,11,11,10,7,,59+2,59+2,59+2,63,62,62,62,63,63+2,63+2,63+2,65+2,64+2,64+2,64+2,65+2,67+2,65+2,65+2,65+2,67+2,67+2,64+2,64+2,64+2,67+2,16+2,LWB,234319,CDM|CM,73,80,5500000.0,27000.0,24,183,63,14.0,Right,3,3,1,Medium/High,Lean (170-185),False,False,False,False,False,False,False,False,False,False,False,False,False,False,False,False,False,False,False,False,False,False,False,False,False,False,False,False,False,False,False,False,False,False,False,False,False,False,False,False,False,False,False,False,69.0,59.0,65.0,69.0,71.0,76.0,61,58,63,72,43,70,55,42,68,70,72,67,61,72,74,69,72,88,68,59,82,68,57,65,49,69.0,72,73,73,12,6,7,13,12,,65+2,65+2,65+2,66,66,66,66,66,67+2,67+2,67+2,68+2,69+2,69+2,69+2,68+2,71+2,72+2,72+2,72+2,71+2,71+2,71+2,71+2,71+2,71+2,17+2,CDM,265459,CDM|CM,64,79,1300000.0,9000.0,19,178,71,14.0,Right,3,2,1,Medium/Medium,Lean (170-185),False,False,False,False,False,False,False,False,False,False,False,False,False,False,False,False,False,False,False,False,False,False,False,False,False,False,False,False,False,False,False,False,False,False,False,False,False,False,False,False,False,False,False,False,65.0,47.0,62.0,67.0,59.0,58.0,52,40,57,69,41,67,50,50,66,69,67,63,61,60,70,55,61,62,50,48,70,58,60,61,57,70.0,56,64,61,12,13,5,13,12,,57+2,57+2,57+2,61,61,61,61,61,62+2,62+2,62+2,62+2,64+2,64+2,64+2,62+2,62+2,63+2,63+2,63+2,62+2,61+2,60+2,60+2,60+2,61+2,17+2,CDM,256358,CDM|CM,63,78,1100000.0,4000.0,19,177,65,14.0,Left,4,2,1,Medium/High,Lean (170-185),False,False,False,False,False,False,False,False,False,False,False,False,False,False,False,False,False,False,False,False,False,False,False,False,False,False,False,False,False,False,False,False,False,False,False,False,False,False,False,False,False,False,False,False,71.0,39.0,56.0,59.0,61.0,65.0,54,37,50,65,34,59,38,32,62,58,70,72,64,59,71,47,59,65,61,33,75,61,49,47,35,44.0,62,63,61,13,13,10,13,14,,52+2,52+2,52+2,56,54,54,54,56,55+2,55+2,55+2,58+2,57+2,57+2,57+2,58+2,62+2,62+2,62+2,62+2,62+2,62+2,62+2,62+2,62+2,62+2,18+2,CDM,211098,CAM|CF,72,72,2400000.0,31000.0,28,173,71,14.0,Right,4,4,1,High/Medium,Stocky (170-185),False,False,False,False,False,False,False,False,False,False,False,False,False,False,False,False,False,False,False,False,False,False,False,False,False,False,False,False,False,False,False,False,False,False,False,False,False,False,False,False,False,False,False,False,70.0,70.0,71.0,75.0,53.0,71.0,68,71,64,72,61,74,76,69,69,75,74,67,81,65,81,70,58,54,77,69,80,55,76,72,62,77.0,46,56,48,10,7,15,16,9,,71+1,71+1,71+1,72,72,72,72,72,72,72,72,71+1,69+2,69+2,69+2,71+1,61+2,63+2,63+2,63+2,61+2,60+2,61+2,61+2,61+2,60+2,17+2,CAM,233795,CF|ST,75,82,11500000.0,38000.0,23,188,75,14.0,Right,3,3,1,High/Medium,Normal (185+),False,False,False,False,False,False,False,False,False,False,False,False,False,False,False,False,False,False,False,False,False,False,False,False,False,False,False,False,False,False,False,False,False,False,False,False,False,False,False,False,False,False,False,False,84.0,73.0,63.0,74.0,41.0,76.0,64,75,70,68,69,75,68,45,53,73,85,83,77,74,65,75,47,78,80,66,69,36,75,65,71,72.0,34,44,37,7,12,13,12,13,,75+2,75+2,75+2,73,74,74,74,73,71+2,71+2,71+2,72+2,66+2,66+2,66+2,72+2,60+2,56+2,56+2,56+2,60+2,58+2,54+2,54+2,54+2,58+2,18+2,ST,213905,CF|ST,70,71,1900000.0,25000.0,26,193,75,14.0,Right,3,3,1,High/High,Normal (185+),False,False,False,False,False,False,False,False,False,False,False,False,False,False,False,False,False,False,False,False,False,False,False,False,False,False,False,False,False,False,False,False,False,False,False,False,False,False,False,False,False,False,False,False,70.0,69.0,58.0,67.0,45.0,75.0,64,70,74,59,71,69,54,45,53,67,65,74,64,69,54,76,75,73,78,64,71,44,68,57,60,59.0,40,41,43,12,11,16,13,8,,70+1,70+1,70+1,66,67,67,67,66,64+2,64+2,64+2,66+2,61+2,61+2,61+2,66+2,58+2,55+2,55+2,55+2,58+2,56+2,56+2,56+2,56+2,56+2,18+2,ST
28,15.0,2022.0,4-3-2-1,to_be_implemented,239358,GK,72,75,2300000.0,18000.0,27,193,90,14.0,Right,3,1,1,Medium/Medium,Normal (185+),False,False,False,False,False,False,False,False,False,False,False,False,False,False,False,False,False,False,False,False,False,False,False,False,False,False,False,False,False,False,False,False,False,False,False,False,False,False,False,False,False,False,False,False,,,,,,,7,9,20,45,8,10,31,8,45,20,39,41,34,72,33,53,66,26,63,5,24,11,6,50,8,44.0,8,9,14,70,68,71,69,75,40.0,27+2,27+2,27+2,25,28,28,28,25,31+2,31+2,31+2,28+2,33+2,33+2,33+2,28+2,24+2,29+2,29+2,29+2,24+2,24+2,25+2,25+2,25+2,24+2,71+2,GK,246159,RB|RWB,70,82,3700000.0,31000.0,20,177,66,14.0,Right,3,3,1,High/Medium,Lean (170-185),False,False,False,False,False,False,False,False,False,False,False,False,False,False,False,False,False,False,False,False,False,False,False,False,False,False,False,False,False,False,False,False,False,False,False,False,False,False,False,False,False,False,False,False,83.0,54.0,64.0,73.0,64.0,69.0,69,54,63,68,31,74,61,32,57,71,84,82,78,67,70,63,76,62,71,53,72,60,60,65,35,69.0,63,68,65,9,12,10,5,15,,64+2,64+2,64+2,69,67,67,67,69,67+2,67+2,67+2,69+2,65+2,65+2,65+2,69+2,68+2,65+2,65+2,65+2,68+2,68+2,67+2,67+2,67+2,68+2,16+2,RB,188182,LCB|CB,74,74,1400000.0,28000.0,34,190,88,14.0,Right,3,2,1,Medium/Medium,Normal (185+),False,False,False,False,False,False,False,False,False,False,False,False,False,False,False,False,False,False,False,False,False,False,False,False,False,False,False,False,False,False,False,False,False,False,False,False,False,False,False,False,False,False,False,False,76.0,44.0,60.0,60.0,73.0,78.0,55,30,74,71,32,60,59,41,63,62,72,79,53,68,57,65,79,69,85,57,72,72,46,47,39,65.0,74,72,76,6,15,12,10,6,,58+2,58+2,58+2,58,58,58,58,58,58+2,58+2,58+2,60+2,62+2,62+2,62+2,60+2,69+2,69+2,69+2,69+2,69+2,70+2,74,74,74,70+2,16+2,CB,223159,RCB|CB,74,77,4900000.0,28000.0,26,195,74,14.0,Right,2,2,1,Medium/Medium,Normal (185+),False,False,False,False,False,False,False,False,False,False,False,False,False,False,False,False,False,False,False,False,False,False,False,False,False,False,False,False,False,False,False,False,False,False,False,False,False,False,False,False,False,False,False,False,61.0,45.0,52.0,59.0,74.0,78.0,51,32,70,66,26,56,27,35,60,65,59,63,54,74,50,65,82,76,83,60,68,74,29,31,49,63.0,74,75,76,12,7,11,7,7,,55+2,55+2,55+2,53,53,53,53,53,53+2,53+2,53+2,56+2,59+2,59+2,59+2,56+2,68+2,69+2,69+2,69+2,68+2,70+2,74+2,74+2,74+2,70+2,16+2,CB,228120,LB|LWB,68,72,1600000.0,12000.0,25,175,68,14.0,Left,3,3,1,High/Medium,Normal (170-185),False,False,False,False,False,False,False,False,False,False,False,False,False,False,False,False,False,False,False,False,False,False,False,False,False,False,False,False,False,False,False,False,False,False,False,False,False,False,False,False,False,False,False,False,81.0,52.0,65.0,72.0,62.0,70.0,66,47,59,67,58,71,67,50,63,70,82,80,81,62,80,62,80,72,70,50,67,67,65,67,45,70.0,60,62,60,11,15,9,13,12,,63+2,63+2,63+2,67,65,65,65,67,66+2,66+2,66+2,68+2,66+2,66+2,66+2,68+2,67+2,65+2,65+2,65+2,67+2,66+2,64+2,64+2,64+2,66+2,18+2,LB,187043,CDM|CM,71,71,1500000.0,22000.0,31,182,78,14.0,Left,3,3,1,High/High,Normal (170-185),False,False,False,False,False,False,False,False,False,False,False,False,False,False,False,False,False,False,False,False,False,False,False,False,False,False,False,False,False,False,False,False,False,False,False,False,False,False,False,False,False,False,False,False,63.0,66.0,73.0,70.0,67.0,72.0,70,64,53,74,64,67,72,75,73,73,60,66,72,71,74,72,64,76,66,70,82,65,67,72,51,74.0,72,70,63,7,16,7,9,14,,66+2,66+2,66+2,69,69,69,69,69,70+1,70+1,70+1,70+1,71,71,71,70+1,69+2,71,71,71,69+2,68+2,68+2,68+2,68+2,68+2,18+2,CM,233957,CDM|CM,68,75,2400000.0,12000.0,24,185,65,14.0,Left,3,2,1,Low/High,Lean (185+),False,False,False,False,False,False,False,False,False,False,False,False,False,False,False,False,False,False,False,False,False,False,False,False,False,False,False,False,False,False,False,False,False,False,False,False,False,False,False,False,False,False,False,False,59.0,54.0,65.0,66.0,66.0,65.0,52,52,63,75,47,65,51,47,75,69,63,55,59,68,68,68,58,75,61,47,63,67,56,61,54,76.0,65,68,66,12,9,7,13,10,,61+2,61+2,61+2,62,63,63,63,62,64+2,64+2,64+2,64+2,68+2,68+2,68+2,64+2,66+2,69+2,69+2,69+2,66+2,66+2,66+2,66+2,66+2,66+2,17+2,CM,232250,CDM|CM,67,72,1500000.0,11000.0,25,179,72,14.0,Left,4,3,1,Medium/Medium,Lean (170-185),False,False,False,False,False,False,False,False,False,False,False,False,False,False,False,False,False,False,False,False,False,False,False,False,False,False,False,False,False,False,False,False,False,False,False,False,False,False,False,False,False,False,False,False,57.0,54.0,66.0,66.0,63.0,62.0,57,49,44,72,36,65,54,48,71,67,57,57,66,67,70,62,65,66,57,64,67,65,57,66,45,66.0,62,68,64,11,8,14,12,9,,58+2,58+2,58+2,62,62,62,62,62,65+2,65+2,65+2,63+2,67+2,67+2,67+2,63+2,64+2,67+2,67+2,67+2,64+2,63+2,63+2,63+2,63+2,63+2,16+2,CM,225785,CAM|CF,73,78,4600000.0,24000.0,24,178,67,14.0,Right,3,4,1,Medium/Medium,Lean (170-185),False,False,False,False,False,False,False,False,False,False,False,False,False,False,False,False,False,False,False,False,False,False,False,False,False,False,False,False,False,False,False,False,False,False,False,False,False,False,False,False,False,False,False,False,83.0,68.0,67.0,76.0,29.0,57.0,67,69,57,70,64,76,68,45,57,74,83,83,86,71,73,69,62,75,58,66,33,23,72,72,60,66.0,24,32,19,9,10,8,9,9,,70+2,70+2,70+2,74,73,73,73,74,73+2,73+2,73+2,73+2,66+2,66+2,66+2,73+2,55+2,49+2,49+2,49+2,55+2,51+2,41+2,41+2,41+2,51+2,16+2,CAM,238490,CAM|CF,71,77,3000000.0,19000.0,24,164,64,14.0,Right,2,3,1,High/Medium,Normal (170-),False,False,False,False,False,False,False,False,False,False,False,False,False,False,False,False,False,False,False,False,False,False,False,False,False,False,False,False,False,False,False,False,False,False,False,False,False,False,False,False,False,False,False,False,75.0,66.0,68.0,73.0,31.0,48.0,62,64,40,72,54,71,64,61,67,71,76,74,88,69,91,72,45,74,41,73,33,22,66,72,52,62.0,34,34,22,11,15,10,6,13,,65+2,65+2,65+2,70,69,69,69,70,71+2,71+2,71+2,70+2,66+2,66+2,66+2,70+2,54+2,51+2,51+2,51+2,54+2,50+2,39+2,39+2,39+2,50+2,18+2,CAM,247279,CF|ST,70,72,2000000.0,20000.0,26,188,84,14.0,Right,3,2,1,High/Medium,Normal (185+),False,False,False,False,False,False,False,False,False,False,False,False,False,False,False,False,False,False,False,False,False,False,False,False,False,False,False,False,False,False,False,False,False,False,False,False,False,False,False,False,False,False,False,False,67.0,69.0,51.0,66.0,29.0,81.0,34,70,78,60,67,64,47,39,52,69,65,68,62,70,66,73,79,76,83,60,81,18,72,54,74,64.0,24,27,23,10,5,9,11,10,,70+2,70+2,70+2,63,67,67,67,63,64+2,64+2,64+2,62+2,59+2,59+2,59+2,62+2,47+2,49+2,49+2,49+2,47+2,45+2,47+2,47+2,47+2,45+2,16+2,ST
29,1801.0,2022.0,4-3-1-2,to_be_implemented,222514,GK,74,79,4900000.0,21000.0,25,188,83,14.0,Right,2,1,1,Medium/Medium,Lean (185+),False,False,False,False,False,False,False,False,False,False,False,False,False,False,False,False,False,False,False,False,False,False,False,False,False,False,False,False,False,False,False,False,False,False,False,False,False,False,False,False,False,False,False,False,,,,,,,14,16,20,26,16,17,15,13,26,22,45,50,38,72,37,53,48,30,46,14,32,26,12,38,20,54.0,10,21,20,75,69,70,72,75,47.0,30+2,30+2,30+2,27,29,29,29,27,28+2,28+2,28+2,28+2,29+2,29+2,29+2,28+2,28+2,28+2,28+2,28+2,28+2,28+2,27+2,27+2,27+2,28+2,73+2,GK,206653,RB|RWB,68,68,1200000.0,12000.0,27,188,81,14.0,Right,2,3,1,High/Medium,Normal (185+),False,False,False,False,False,False,False,False,False,False,False,False,False,False,False,False,False,False,False,False,False,False,False,False,False,False,False,False,False,False,False,False,False,False,False,False,False,False,False,False,False,False,False,False,72.0,65.0,66.0,67.0,61.0,76.0,63,63,58,69,60,67,55,57,63,70,66,76,64,66,60,74,63,87,77,62,65,57,67,69,53,64.0,66,60,57,16,13,13,15,16,,67+1,67+1,67+1,67,68,68,68,67,67+1,67+1,67+1,68,67+1,67+1,67+1,68,66+2,66+2,66+2,66+2,66+2,65+2,64+2,64+2,64+2,65+2,21+2,RWB,204496,LCB|CB,72,72,2000000.0,23000.0,29,192,88,14.0,Right,3,2,1,Medium/Medium,Normal (185+),False,False,False,False,False,False,False,False,False,False,False,False,False,False,False,False,False,False,False,False,False,False,False,False,False,False,False,False,False,False,False,False,False,False,False,False,False,False,False,False,False,False,False,False,32.0,45.0,53.0,46.0,73.0,76.0,46,36,75,64,42,38,39,54,61,56,33,31,40,71,34,71,52,49,92,43,74,71,34,40,52,63.0,75,72,71,12,14,6,15,11,,52+2,52+2,52+2,45,47,47,47,45,48+2,48+2,48+2,47+2,55+2,55+2,55+2,47+2,59+2,66+2,66+2,66+2,59+2,61+2,72,72,72,61+2,19+2,CB,214906,RCB|CB,70,70,1300000.0,17000.0,30,190,81,14.0,Left,2,2,1,Medium/High,Normal (185+),False,False,False,False,False,False,False,False,False,False,False,False,False,False,False,False,False,False,False,False,False,False,False,False,False,False,False,False,False,False,False,False,False,False,False,False,False,False,False,False,False,False,False,False,63.0,40.0,59.0,60.0,70.0,76.0,63,35,72,63,27,55,65,68,64,64,61,64,67,68,56,46,81,76,77,48,73,70,45,42,42,59.0,69,71,67,15,13,13,7,10,,54+2,54+2,54+2,56,54,54,54,56,55+2,55+2,55+2,58+2,60+2,60+2,60+2,58+2,67+2,67+2,67+2,67+2,67+2,68+2,70,70,70,68+2,18+2,CB,198190,LB|LWB,69,69,1000000.0,15000.0,31,183,70,14.0,Left,3,3,1,Medium/High,Normal (170-185),False,False,False,False,False,False,False,False,False,False,False,False,False,False,False,False,False,False,False,False,False,False,False,False,False,False,False,False,False,False,False,False,False,False,False,False,False,False,False,False,False,False,False,False,63.0,54.0,64.0,68.0,68.0,72.0,69,55,67,68,25,68,52,56,64,68,60,65,68,66,67,60,76,65,72,54,82,67,60,55,44,69.0,68,68,67,16,16,9,11,7,,62+2,62+2,62+2,64,63,63,63,64,63+2,63+2,63+2,65+2,64+2,64+2,64+2,65+2,67+2,67+2,67+2,67+2,67+2,67+2,69,69,69,67+2,18+2,LWB,216464,CDM|CM,72,72,2500000.0,24000.0,27,173,71,14.0,Right,4,3,1,High/High,Normal (170-185),False,False,False,False,False,False,False,False,False,False,False,False,False,False,False,False,False,False,False,False,False,False,False,False,False,False,False,False,False,False,False,False,False,False,False,False,False,False,False,False,False,False,False,False,75.0,69.0,69.0,71.0,69.0,82.0,65,68,70,73,70,69,55,51,70,70,73,76,76,73,78,68,90,92,75,71,84,70,72,71,69,71.0,69,70,67,13,16,12,11,14,,71+1,71+1,71+1,71,71,71,71,71,71+1,71+1,71+1,72,72,72,72,72,72,73-1,73-1,73-1,72,72,72,72,72,72,20+2,CM,222836,CDM|CM,72,75,2900000.0,19000.0,24,175,69,14.0,Right,2,2,1,Medium/Medium,Normal (170-185),False,False,False,False,False,False,False,False,False,False,False,False,False,False,False,False,False,False,False,False,False,False,False,False,False,False,False,False,False,False,False,False,False,False,False,False,False,False,False,False,False,False,False,False,63.0,56.0,69.0,66.0,67.0,74.0,64,58,58,72,45,63,66,64,70,69,62,63,68,67,70,59,67,83,65,52,87,68,59,70,53,70.0,66,70,68,14,16,16,8,11,,61+2,61+2,61+2,64,64,64,64,64,66+2,66+2,66+2,66+2,69+2,69+2,69+2,66+2,69+2,71+2,71+2,71+2,69+2,68+2,68+2,68+2,68+2,68+2,18+2,CDM,225071,CDM|CM,71,74,2400000.0,22000.0,26,185,68,14.0,Right,3,3,1,Medium/Medium,Normal (185+),False,False,False,False,False,False,False,False,False,False,False,False,False,False,False,False,False,False,False,False,False,False,False,False,False,False,False,False,False,False,False,False,False,False,False,False,False,False,False,False,False,False,False,False,68.0,64.0,69.0,70.0,65.0,72.0,63,61,55,73,58,66,62,67,72,72,68,68,74,71,76,70,68,81,71,68,66,68,65,70,64,74.0,64,68,64,8,7,8,6,6,,66+2,66+2,66+2,68,68,68,68,68,69+2,69+2,69+2,69+2,71+2,71+2,71+2,69+2,69+2,70+2,70+2,70+2,69+2,68+2,66+2,66+2,66+2,68+2,14+2,CM,201887,CAM|CF,72,72,2300000.0,26000.0,29,174,67,14.0,Left,3,3,1,Medium/Medium,Lean (170-185),False,False,False,False,False,False,False,False,False,False,False,False,False,False,False,False,False,False,False,False,False,False,False,False,False,False,False,False,False,False,False,False,False,False,False,False,False,False,False,False,False,False,False,False,74.0,69.0,71.0,73.0,55.0,66.0,69,69,40,73,57,70,73,66,68,75,75,74,79,68,83,70,58,80,65,68,52,58,74,73,77,78.0,55,59,49,13,8,11,16,10,,68+2,68+2,68+2,72,71,71,71,72,72,72,72,72,71+1,71+1,71+1,72,66+2,65+2,65+2,65+2,66+2,64+2,58+2,58+2,58+2,64+2,18+2,CAM,231616,CF|ST,71,75,2700000.0,21000.0,24,190,87,14.0,Right,4,3,1,High/Medium,Lean (185+),False,False,False,False,False,False,False,False,False,False,False,False,False,False,False,False,False,False,False,False,False,False,False,False,False,False,False,False,False,False,False,False,False,False,False,False,False,False,False,False,False,False,False,False,76.0,70.0,53.0,67.0,28.0,73.0,42,72,70,59,64,69,44,57,49,68,67,84,63,68,58,73,55,74,79,68,61,24,71,60,62,61.0,21,25,26,13,5,13,10,14,,71+2,71+2,71+2,66,69,69,69,66,66+2,66+2,66+2,65+2,59+2,59+2,59+2,65+2,49+2,47+2,47+2,47+2,49+2,47+2,44+2,44+2,44+2,47+2,17+2,ST,212223,CF|ST,68,68,1200000.0,15000.0,28,175,68,14.0,Right,3,3,1,High/Medium,Lean (170-185),False,False,False,False,False,False,False,False,False,False,False,False,False,False,False,False,False,False,False,False,False,False,False,False,False,False,False,False,False,False,False,False,False,False,False,False,False,False,False,False,False,False,False,False,87.0,63.0,56.0,72.0,36.0,65.0,53,67,65,62,56,70,38,36,48,71,92,82,89,65,85,61,72,77,63,55,53,28,69,63,66,65.0,43,28,22,15,10,13,12,12,,68,68,68,69-1,69-1,69-1,69-1,69-1,67+1,67+1,67+1,68,60+2,60+2,60+2,68,54+2,50+2,50+2,50+2,54+2,51+2,46+2,46+2,46+2,51+2,18+2,ST
30,1800.0,2022.0,4-3-1-2,to_be_implemented,194150,GK,70,70,800000.0,10000.0,32,191,83,14.0,Right,3,1,1,Medium/Medium,Normal (185+),False,False,False,False,False,False,False,False,False,False,False,False,False,False,False,False,False,False,False,False,False,False,False,False,False,False,False,False,False,False,False,False,False,False,False,False,False,False,False,False,False,False,False,False,,,,,,,14,13,20,50,14,14,14,12,57,34,50,48,58,64,39,55,46,36,60,19,34,23,13,61,11,49.0,15,13,18,69,69,73,68,70,49.0,32+2,32+2,32+2,32,34,34,34,32,38+2,38+2,38+2,35+2,40+2,40+2,40+2,35+2,30+2,36+2,36+2,36+2,30+2,30+2,29+2,29+2,29+2,30+2,69+1,GK,204847,RB|RWB,70,70,1400000.0,12000.0,28,180,70,14.0,Right,2,3,1,High/Medium,Lean (170-185),False,False,False,False,False,False,False,False,False,False,False,False,False,False,False,False,False,False,False,False,False,False,False,False,False,False,False,False,False,False,False,False,False,False,False,False,False,False,False,False,False,False,False,False,74.0,51.0,64.0,65.0,64.0,67.0,71,44,54,64,35,64,68,57,60,65,76,73,71,65,69,64,63,74,63,54,68,64,64,63,50,64.0,64,66,68,9,13,16,14,6,,60+2,60+2,60+2,64,62,62,62,64,63+2,63+2,63+2,65+2,63+2,63+2,63+2,65+2,68+2,65+2,65+2,65+2,68+2,67+2,64+2,64+2,64+2,67+2,17+2,RWB,173671,LCB|CB,70,70,425000.0,9000.0,35,185,85,14.0,Right,2,2,1,Medium/High,Normal (185+),False,False,False,False,False,False,False,False,False,False,False,False,False,False,False,False,False,False,False,False,False,False,False,False,False,False,False,False,False,False,False,False,False,False,False,False,False,False,False,False,False,False,False,False,34.0,37.0,49.0,49.0,70.0,79.0,20,35,73,64,28,47,22,35,64,52,33,34,33,65,47,51,74,69,84,33,80,71,26,49,36,58.0,72,69,63,11,13,11,6,6,,48+2,48+2,48+2,42,46,46,46,42,48+2,48+2,48+2,46+2,56+2,56+2,56+2,46+2,56+2,66+2,66+2,66+2,56+2,58+2,70,70,70,58+2,15+2,CB,252001,RCB|CB,70,77,3000000.0,20000.0,21,185,72,14.0,Left,3,2,1,Medium/High,Lean (185+),False,False,False,False,False,False,False,False,False,False,False,False,False,False,False,False,False,False,False,False,False,False,False,False,False,False,False,False,False,False,False,False,False,False,False,False,False,False,False,False,False,False,False,False,68.0,42.0,62.0,62.0,70.0,72.0,63,35,68,66,33,61,53,33,65,66,64,72,57,69,65,61,77,64,76,39,69,70,41,59,43,51.0,68,72,69,9,10,6,12,8,,56+2,56+2,56+2,58,57,57,57,58,59+2,59+2,59+2,61+2,62+2,62+2,62+2,61+2,67+2,68+2,68+2,68+2,67+2,68+2,70+2,70+2,70+2,68+2,16+2,CB,196952,LB|LWB,71,71,1600000.0,14000.0,29,183,80,14.0,Left,2,2,1,High/Medium,Normal (170-185),False,False,False,False,False,False,False,False,False,False,False,False,False,False,False,False,False,False,False,False,False,False,False,False,False,False,False,False,False,False,False,False,False,False,False,False,False,False,False,False,False,False,False,False,68.0,48.0,66.0,64.0,68.0,76.0,74,37,65,66,44,61,58,63,65,69,67,68,62,69,64,66,68,81,73,51,78,67,63,63,49,66.0,70,69,65,13,13,12,12,12,,60+2,60+2,60+2,63,62,62,62,63,62+2,62+2,62+2,65+2,66+2,66+2,66+2,65+2,69+2,69+2,69+2,69+2,69+2,69+2,69+2,69+2,69+2,69+2,19+2,LWB,234741,CDM|CM,74,79,6000000.0,20000.0,25,169,61,14.0,Right,3,3,1,Medium/Medium,Stocky (170-),False,False,False,False,False,False,False,False,False,False,False,False,False,False,False,False,False,False,False,False,False,False,False,False,False,False,False,False,False,False,False,False,False,False,False,False,False,False,False,False,False,False,False,False,69.0,69.0,75.0,72.0,71.0,77.0,74,65,66,74,66,68,73,73,77,73,71,68,77,73,86,76,80,82,70,74,87,74,67,75,60,72.0,71,71,68,12,7,7,9,10,,69+2,69+2,69+2,71,71,71,71,71,72+2,72+2,72+2,72+2,74+2,74+2,74+2,72+2,73+2,74+2,74+2,74+2,73+2,72+2,72+2,72+2,72+2,72+2,16+2,CM,225779,CDM|CM,71,77,2700000.0,12000.0,24,185,64,14.0,Right,3,2,1,Medium/High,Lean (185+),False,False,False,False,False,False,False,False,False,False,False,False,False,False,False,False,False,False,False,False,False,False,False,False,False,False,False,False,False,False,False,False,False,False,False,False,False,False,False,False,False,False,False,False,50.0,46.0,69.0,65.0,69.0,73.0,61,37,63,75,52,63,64,62,74,67,47,52,65,63,62,57,69,75,73,51,73,71,54,65,54,67.0,69,69,66,15,10,15,13,11,,56+2,56+2,56+2,59,59,59,59,59,62+2,62+2,62+2,62+2,67+2,67+2,67+2,62+2,66+2,70+2,70+2,70+2,66+2,66+2,69+2,69+2,69+2,66+2,18+2,CDM,213147,CDM|CM,69,70,1600000.0,11000.0,27,170,66,14.0,Right,3,2,1,High/High,Normal (170-),False,False,False,False,False,False,False,False,False,False,False,False,False,False,False,False,False,False,False,False,False,False,False,False,False,False,False,False,False,False,False,False,False,False,False,False,False,False,False,False,False,False,False,False,76.0,58.0,67.0,71.0,65.0,71.0,62,58,53,72,48,69,57,53,67,68,78,75,81,69,86,58,77,85,61,59,76,66,66,68,52,67.0,65,67,66,11,16,6,8,8,,64+2,64+2,64+2,68,67,67,67,68,68+2,68+2,68+2,69+1,69+1,69+1,69+1,69+1,70,69+1,69+1,69+1,70,69+1,66+2,66+2,66+2,69+1,17+2,CM,238058,CAM|CF,73,80,6000000.0,17000.0,24,173,65,14.0,Right,3,3,1,High/High,Lean (170-185),False,False,False,False,False,False,False,False,False,False,False,False,False,False,False,False,False,False,False,False,False,False,False,False,False,False,False,False,False,False,False,False,False,False,False,False,False,False,False,False,False,False,False,False,81.0,58.0,69.0,77.0,63.0,66.0,62,59,51,73,55,78,63,52,71,73,84,79,83,73,87,54,81,90,47,56,79,64,74,72,58,69.0,64,67,61,11,7,11,14,15,,65+2,65+2,65+2,72,71,71,71,72,73+2,73+2,73+2,74+2,72+2,72+2,72+2,74+2,71+2,70+2,70+2,70+2,71+2,69+2,64+2,64+2,64+2,69+2,18+2,CAM,241651,CF|ST,72,78,3700000.0,16000.0,24,187,86,14.0,Right,3,3,1,High/Medium,Normal (185+),False,False,False,False,False,False,False,False,False,False,False,False,False,False,False,False,False,False,False,False,False,False,False,False,False,False,False,False,False,False,False,False,False,False,False,False,False,False,False,False,False,False,False,False,75.0,71.0,63.0,73.0,29.0,76.0,61,73,65,67,67,74,70,59,52,73,72,78,70,69,71,71,65,77,79,69,68,23,75,64,63,68.0,28,25,16,10,13,11,14,8,,72+2,72+2,72+2,71,72,72,72,71,70+2,70+2,70+2,70+2,63+2,63+2,63+2,70+2,52+2,50+2,50+2,50+2,52+2,49+2,45+2,45+2,45+2,49+2,18+2,ST,187157,CF|ST,70,70,1600000.0,14000.0,30,180,74,14.0,Right,3,2,1,High/Medium,Normal (170-185),False,False,False,False,False,False,False,False,False,False,False,False,False,False,False,False,False,False,False,False,False,False,False,False,False,False,False,False,False,False,False,False,False,False,False,False,False,False,False,False,False,False,False,False,58.0,72.0,55.0,67.0,32.0,68.0,42,74,72,62,71,63,58,59,47,69,61,56,67,73,77,72,82,70,68,65,61,37,76,58,74,70.0,24,26,21,9,10,15,15,9,,70,70,70,64,67,67,67,64,65+2,65+2,65+2,63+2,60+2,60+2,60+2,63+2,48+2,49+2,49+2,49+2,48+2,46+2,46+2,46+2,46+2,46+2,18+2,ST
31,1919.0,2022.0,3-5-2,to_be_implemented,198350,GK,73,75,2600000.0,22000.0,28,188,72,14.0,Right,3,1,1,Medium/Medium,Lean (185+),False,False,False,False,False,False,False,False,False,False,False,False,False,False,False,False,False,False,False,False,False,False,False,False,False,False,False,False,False,False,False,False,False,False,False,False,False,False,False,False,False,False,False,False,,,,,,,18,11,11,43,13,17,12,12,26,30,48,43,51,72,41,52,75,31,67,13,24,22,12,50,22,55.0,30,11,13,77,66,69,72,73,46.0,30+2,30+2,30+2,31,32,32,32,31,34+2,34+2,34+2,32+2,33+2,33+2,33+2,32+2,30+2,32+2,32+2,32+2,30+2,29+2,30+2,30+2,30+2,29+2,72+2,GK,201122,RCB|CB,72,73,2200000.0,23000.0,29,184,86,14.0,Right,3,2,1,Medium/High,Normal (170-185),False,False,False,False,False,False,False,False,False,False,False,False,False,False,False,False,False,False,False,False,False,False,False,False,False,False,False,False,False,False,False,False,False,False,False,False,False,False,False,False,False,False,False,False,71.0,47.0,56.0,64.0,71.0,76.0,54,38,74,66,24,61,29,31,60,64,70,71,67,70,67,66,84,74,79,54,70,72,46,48,53,70.0,70,71,72,8,8,9,7,7,,59+2,59+2,59+2,59,58,58,58,59,59+2,59+2,59+2,60+2,61+2,61+2,61+2,60+2,68+2,68+2,68+2,68+2,68+2,69+2,72+1,72+1,72+1,69+2,14+2,CB,199383,CB,71,71,600000.0,20000.0,34,194,85,14.0,Right,3,2,1,Low/Medium,Lean (185+),False,False,False,False,False,False,False,False,False,False,False,False,False,False,False,False,False,False,False,False,False,False,False,False,False,False,False,False,False,False,False,False,False,False,False,False,False,False,False,False,False,False,False,False,32.0,38.0,54.0,38.0,74.0,67.0,34,29,78,66,32,28,38,26,69,45,31,32,28,68,29,64,56,34,83,35,70,73,40,54,30,75.0,73,74,71,15,10,11,15,10,,49+2,49+2,49+2,41,45,45,45,41,46+2,46+2,46+2,43+2,55+2,55+2,55+2,43+2,55+2,66+2,66+2,66+2,55+2,59+2,71,71,71,59+2,19+2,CB,205054,LCB|CB,71,71,1500000.0,20000.0,30,185,78,14.0,Left,3,3,1,High/Medium,Normal (185+),False,False,False,False,False,False,False,False,False,False,False,False,False,False,False,False,False,False,False,False,False,False,False,False,False,False,False,False,False,False,False,False,False,False,False,False,False,False,False,False,False,False,False,False,67.0,65.0,65.0,67.0,70.0,77.0,68,63,70,64,45,67,68,74,61,64,69,66,74,69,74,73,81,79,78,71,73,70,52,64,59,64.0,70,71,69,9,12,6,10,7,,65+2,65+2,65+2,65,64,64,64,65,64+2,64+2,64+2,65+2,65+2,65+2,65+2,65+2,69+2,68+2,68+2,68+2,69+2,69+2,71,71,71,69+2,16+2,CB,235618,RM|RWB|RB,67,74,2000000.0,9000.0,22,178,71,14.0,Right,4,3,1,High/Medium,Normal (170-185),False,False,False,False,False,False,False,False,False,False,False,False,False,False,False,False,False,False,False,False,False,False,False,False,False,False,False,False,False,False,False,False,False,False,False,False,False,False,False,False,False,False,False,False,86.0,52.0,60.0,68.0,56.0,70.0,65,50,52,58,41,68,62,52,55,67,87,85,79,58,73,52,75,89,64,59,58,55,60,65,51,62.0,57,58,56,8,14,11,14,9,,60+2,60+2,60+2,66,63,63,63,66,64+2,64+2,64+2,67+2,62+2,62+2,62+2,67+2,65+2,60+2,60+2,60+2,65+2,64+2,59+2,59+2,59+2,64+2,16+2,RWB,224265,CDM|CM,70,74,2000000.0,16000.0,25,185,80,14.0,Right,2,3,1,Medium/High,Normal (185+),False,False,False,False,False,False,False,False,False,False,False,False,False,False,False,False,False,False,False,False,False,False,False,False,False,False,False,False,False,False,False,False,False,False,False,False,False,False,False,False,False,False,False,False,60.0,56.0,67.0,67.0,68.0,66.0,60,53,54,72,62,69,58,54,73,67,65,56,63,65,67,63,49,64,62,58,84,66,47,65,59,63.0,68,72,71,14,9,10,10,9,,59+2,59+2,59+2,62,62,62,62,62,64+2,64+2,64+2,64+2,67+2,67+2,67+2,64+2,66+2,69+2,69+2,69+2,66+2,66+2,67+2,67+2,67+2,66+2,16+2,CDM,186139,CDM|CM,69,69,1300000.0,16000.0,30,181,86,14.0,Right,3,3,1,Medium/Medium,Stocky (170-185),False,False,False,False,False,False,False,False,False,False,False,False,False,False,False,False,False,False,False,False,False,False,False,False,False,False,False,False,False,False,False,False,False,False,False,False,False,False,False,False,False,False,False,False,52.0,62.0,72.0,67.0,66.0,68.0,72,59,63,74,49,66,73,67,71,70,54,50,58,66,64,69,69,64,70,63,68,65,64,71,58,71.0,70,65,64,7,10,15,8,14,,64+2,64+2,64+2,65,65,65,65,65,67+2,67+2,67+2,66+2,69,69,69,66+2,66+2,68+1,68+1,68+1,66+2,65+2,67+2,67+2,67+2,65+2,16+2,CM,246594,CDM|CM,69,81,3200000.0,11000.0,20,175,70,14.0,Right,3,3,1,Medium/High,Lean (170-185),False,False,False,False,False,False,False,False,False,False,False,False,False,False,False,False,False,False,False,False,False,False,False,False,False,False,False,False,False,False,False,False,False,False,False,False,False,False,False,False,False,False,False,False,72.0,48.0,65.0,72.0,66.0,65.0,56,39,60,72,39,72,50,44,70,68,74,70,85,66,85,63,61,70,63,54,65,70,57,66,51,68.0,64,66,65,8,14,12,9,15,,59+2,59+2,59+2,64,63,63,63,64,66+2,66+2,66+2,66+2,67+2,67+2,67+2,66+2,67+2,68+2,68+2,68+2,67+2,67+2,65+2,65+2,65+2,67+2,18+2,CDM,232755,LM|LWB|LB,70,75,2200000.0,15000.0,24,170,64,14.0,Left,3,3,1,Medium/Medium,Normal (170-),False,False,False,False,False,False,False,False,False,False,False,False,False,False,False,False,False,False,False,False,False,False,False,False,False,False,False,False,False,False,False,False,False,False,False,False,False,False,False,False,False,False,False,False,85.0,40.0,62.0,72.0,65.0,57.0,66,35,51,68,34,71,69,59,49,70,89,81,85,64,84,50,71,67,49,38,62,67,58,54,43,65.0,65,69,67,13,15,12,8,5,,56+2,56+2,56+2,65,62,62,62,65,63+2,63+2,63+2,66+2,61+2,61+2,61+2,66+2,69+2,64+2,64+2,64+2,69+2,68+2,64+2,64+2,64+2,68+2,16+2,LB,194017,CF|ST,73,73,3000000.0,30000.0,30,178,76,14.0,Right,3,3,1,High/High,Normal (170-185),False,False,False,False,False,False,False,False,False,False,False,False,False,False,False,False,False,False,False,False,False,False,False,False,False,False,False,False,False,False,False,False,False,False,False,False,False,False,False,False,False,False,False,False,82.0,72.0,65.0,71.0,45.0,72.0,63,74,69,67,69,71,68,64,55,71,83,81,77,73,68,74,60,87,65,68,74,52,76,70,67,65.0,40,41,34,11,9,16,12,6,,73,73,73,72,73,73,73,72,71+2,71+2,71+2,72+1,67+2,67+2,67+2,72+1,62+2,59+2,59+2,59+2,62+2,59+2,55+2,55+2,55+2,59+2,17+2,ST,241236,CF|ST,70,79,3600000.0,18000.0,22,180,70,14.0,Right,4,3,1,High/Medium,Normal (170-185),False,False,False,False,False,False,False,False,False,False,False,False,False,False,False,False,False,False,False,False,False,False,False,False,False,False,False,False,False,False,False,False,False,False,False,False,False,False,False,False,False,False,False,False,85.0,68.0,58.0,71.0,22.0,74.0,62,68,63,64,56,72,49,39,39,69,81,88,75,68,68,77,69,71,80,64,62,14,68,65,51,62.0,20,19,11,10,11,14,15,7,,70+2,70+2,70+2,70,70,70,70,70,68+2,68+2,68+2,68+2,58+2,58+2,58+2,68+2,49+2,44+2,44+2,44+2,49+2,46+2,41+2,41+2,41+2,46+2,17+2,ST
32,1793.0,2022.0,3-5-2,to_be_implemented,217096,GK,67,71,1100000.0,7000.0,27,190,73,14.0,Right,3,1,1,Medium/Medium,Lean (185+),False,False,False,False,False,False,False,False,False,False,False,False,False,False,False,False,False,False,False,False,False,False,False,False,False,False,False,False,False,False,False,False,False,False,False,False,False,False,False,False,False,False,False,False,,,,,,,18,12,19,21,15,19,15,13,18,23,43,46,30,64,51,53,51,38,51,16,26,25,19,45,17,28.0,20,19,20,68,66,71,64,67,44.0,29+2,29+2,29+2,27,29,29,29,27,28+2,28+2,28+2,28+2,28+2,28+2,28+2,28+2,28+2,28+2,28+2,28+2,28+2,28+2,28+2,28+2,28+2,28+2,66+2,GK,157665,RCB|CB,69,69,375000.0,7000.0,35,190,78,14.0,Right,3,2,2,Low/Medium,Normal (185+),False,False,False,False,False,False,False,False,False,False,False,False,False,False,False,False,False,False,False,False,False,False,False,False,False,False,False,False,False,False,False,False,False,False,False,False,False,False,False,False,False,False,False,False,31.0,40.0,48.0,48.0,71.0,64.0,30,40,76,57,29,40,30,29,61,58,29,32,36,67,50,52,72,31,78,32,66,71,36,48,30,68.0,70,72,68,6,10,15,7,9,,50+2,50+2,50+2,43,47,47,47,43,48+2,48+2,48+2,45+2,53+2,53+2,53+2,45+2,54+2,63+2,63+2,63+2,54+2,57+2,69,69,69,57+2,15+2,CB,200758,CB,68,68,1000000.0,8000.0,29,185,86,14.0,Right,4,2,1,Medium/High,Normal (185+),False,False,False,False,False,False,False,False,False,False,False,False,False,False,False,False,False,False,False,False,False,False,False,False,False,False,False,False,False,False,False,False,False,False,False,False,False,False,False,False,False,False,False,False,66.0,33.0,57.0,60.0,66.0,75.0,58,24,66,61,34,60,37,24,61,61,60,71,55,63,63,55,80,61,80,32,77,68,37,60,20,65.0,64,66,70,8,9,7,8,10,,51+2,51+2,51+2,54,53,53,53,54,55+2,55+2,55+2,57+2,58+2,58+2,58+2,57+2,64+2,65+2,65+2,65+2,64+2,65+2,68,68,68,65+2,15+2,CB,212420,LCB|CB,68,69,1100000.0,8000.0,28,196,89,14.0,Left,2,2,1,Medium/Medium,Normal (185+),False,False,False,False,False,False,False,False,False,False,False,False,False,False,False,False,False,False,False,False,False,False,False,False,False,False,False,False,False,False,False,False,False,False,False,False,False,False,False,False,False,False,False,False,45.0,32.0,54.0,49.0,67.0,80.0,40,26,69,67,31,50,29,38,61,52,33,54,33,57,31,47,51,73,91,31,70,62,31,51,39,58.0,66,69,69,14,12,8,8,8,,47+2,47+2,47+2,45,46,46,46,45,49+2,49+2,49+2,49+2,56+2,56+2,56+2,49+2,59+2,65+2,65+2,65+2,59+2,60+2,68+1,68+1,68+1,60+2,15+2,CB,208052,RM|RWB|RB,72,72,2000000.0,14000.0,30,180,75,14.0,Right,3,3,1,High/High,Normal (170-185),False,False,False,False,False,False,False,False,False,False,False,False,False,False,False,False,False,False,False,False,False,False,False,False,False,False,False,False,False,False,False,False,False,False,False,False,False,False,False,False,False,False,False,False,80.0,53.0,61.0,70.0,68.0,77.0,63,52,64,63,41,70,62,42,55,68,77,82,75,64,75,57,84,85,69,51,83,68,66,64,49,67.0,64,71,74,9,8,7,9,9,,63+2,63+2,63+2,66,65,65,65,66,65+2,65+2,65+2,67+2,65+2,65+2,65+2,67+2,70+2,68+2,68+2,68+2,70+2,70+2,70+2,70+2,70+2,70+2,15+2,RWB,245021,CDM|CM,73,78,4100000.0,10000.0,25,188,80,14.0,Right,2,2,1,Medium/High,Normal (185+),False,False,False,False,False,False,False,False,False,False,False,False,False,False,False,False,False,False,False,False,False,False,False,False,False,False,False,False,False,False,False,False,False,False,False,False,False,False,False,False,False,False,False,False,43.0,53.0,60.0,63.0,72.0,80.0,42,40,69,74,38,64,50,42,67,66,42,44,49,70,42,78,75,75,81,63,85,73,50,57,47,72.0,71,75,66,11,13,11,8,6,,59+2,59+2,59+2,56,59,59,59,56,61+2,61+2,61+2,58+2,66+2,66+2,66+2,58+2,65+2,72+2,72+2,72+2,65+2,65+2,73+2,73+2,73+2,65+2,16+2,CDM,200478,CDM|CM,71,71,1800000.0,45000.0,30,185,79,14.0,Right,3,3,2,Medium/Medium,Normal (185+),False,False,False,False,False,False,False,False,False,False,False,False,False,False,False,False,False,False,False,False,False,False,False,False,False,False,False,False,False,False,False,False,False,False,False,False,False,False,False,False,False,False,False,False,62.0,68.0,72.0,71.0,69.0,73.0,71,66,64,73,68,72,72,64,73,72,64,60,66,71,69,74,74,72,73,70,75,69,70,71,60,73.0,70,69,67,12,6,9,9,14,,69+2,69+2,69+2,70,70,70,70,70,70+1,70+1,70+1,70+1,71,71,71,70+1,70+1,71,71,71,70+1,69+2,70+1,70+1,70+1,69+2,17+2,CM,251420,CDM|CM,65,72,1400000.0,11000.0,22,185,72,14.0,Right,3,2,1,Medium/High,Lean (185+),False,False,False,False,False,False,False,False,False,False,False,False,False,False,False,False,False,False,False,False,False,False,False,False,False,False,False,False,False,False,False,False,False,False,False,False,False,False,False,False,False,False,False,False,65.0,50.0,58.0,63.0,62.0,73.0,45,45,56,64,45,61,47,38,62,62,69,61,68,64,69,63,69,79,73,48,65,61,59,63,47,67.0,61,65,62,6,9,9,11,12,,58+2,58+2,58+2,59,60,60,60,59,61+2,61+2,61+2,61+2,63+2,63+2,63+2,61+2,62+2,64+2,64+2,64+2,62+2,62+2,63+2,63+2,63+2,62+2,15+2,CDM,236246,LM|LWB|LB,71,76,2800000.0,12000.0,24,188,74,14.0,Right,3,4,1,Medium/Medium,Lean (185+),False,False,False,False,False,False,False,False,False,False,False,False,False,False,False,False,False,False,False,False,False,False,False,False,False,False,False,False,False,False,False,False,False,False,False,False,False,False,False,False,False,False,False,False,60.0,63.0,67.0,80.0,64.0,63.0,63,63,50,72,54,81,70,49,66,81,67,54,90,62,78,63,39,77,63,65,52,67,60,67,57,72.0,64,65,70,15,9,11,14,10,,64+2,64+2,64+2,70,68,68,68,70,71+2,71+2,71+2,70+2,70+2,70+2,70+2,70+2,68+2,68+2,68+2,68+2,68+2,67+2,63+2,63+2,63+2,67+2,17+2,LM,210556,CF|ST,73,73,3100000.0,19000.0,28,193,80,14.0,Right,4,4,1,Medium/Low,Normal (185+),False,False,False,False,False,False,False,False,False,False,False,False,False,False,False,False,False,False,False,False,False,False,False,False,False,False,False,False,False,False,False,False,False,False,False,False,False,False,False,False,False,False,False,False,69.0,73.0,61.0,72.0,27.0,65.0,48,73,72,63,66,75,73,44,61,74,60,77,66,66,48,81,54,46,86,69,40,22,70,71,60,65.0,20,23,20,11,10,13,13,10,,73,73,73,68,71,71,71,68,69+2,69+2,69+2,66+2,62+2,62+2,62+2,66+2,46+2,47+2,47+2,47+2,46+2,44+2,43+2,43+2,43+2,44+2,17+2,ST,169216,CF|ST,71,71,800000.0,11000.0,35,178,70,14.0,Right,2,3,2,High/High,Normal (170-185),False,False,False,False,False,False,False,False,False,False,False,False,False,False,False,False,False,False,False,False,False,False,False,False,False,False,False,False,False,False,False,False,False,False,False,False,False,False,False,False,False,False,False,False,78.0,68.0,61.0,71.0,36.0,61.0,72,66,74,62,67,73,54,44,49,70,79,77,69,72,72,73,92,38,62,64,80,42,75,63,72,67.0,31,27,24,11,13,10,11,10,,71,71,71,70,70,70,70,70,68+2,68+2,68+2,68+2,60+2,60+2,60+2,68+2,53+2,50+2,50+2,50+2,53+2,51+2,50+2,50+2,50+2,51+2,18+2,ST
33,97.0,2022.0,4-3-1-2,to_be_implemented,155871,GK,71,71,325000.0,8000.0,34,194,86,14.0,Right,3,1,1,Medium/Medium,Normal (185+),False,False,False,False,False,False,False,False,False,False,False,False,False,False,False,False,False,False,False,False,False,False,False,False,False,False,False,False,False,False,False,False,False,False,False,False,False,False,False,False,False,False,False,False,,,,,,,11,13,12,47,12,14,11,12,52,18,42,40,44,70,49,51,66,39,69,11,27,19,10,57,17,61.0,9,15,14,66,71,68,75,70,41.0,28+2,28+2,28+2,28,30,30,30,28,34+2,34+2,34+2,31+2,37+2,37+2,37+2,31+2,27+2,33+2,33+2,33+2,27+2,26+2,27+2,27+2,27+2,26+2,70+1,GK,239443,RB|RWB,69,75,2100000.0,6000.0,23,174,72,14.0,Right,2,2,1,High/High,Lean (170-185),False,False,False,False,False,False,False,False,False,False,False,False,False,False,False,False,False,False,False,False,False,False,False,False,False,False,False,False,False,False,False,False,False,False,False,False,False,False,False,False,False,False,False,False,78.0,41.0,59.0,67.0,64.0,66.0,64,38,57,64,31,65,49,40,56,65,79,78,77,67,77,50,61,75,64,36,62,62,57,53,41,58.0,64,66,64,14,6,6,11,15,,57+2,57+2,57+2,62,59,59,59,62,60+2,60+2,60+2,64+2,61+2,61+2,61+2,64+2,67+2,64+2,64+2,64+2,67+2,67+2,64+2,64+2,64+2,67+2,17+2,RWB,216481,LCB|CB,73,74,3100000.0,12000.0,27,199,85,14.0,Left,2,2,1,Medium/Medium,Normal (185+),False,False,False,False,False,False,False,False,False,False,False,False,False,False,False,False,False,False,False,False,False,False,False,False,False,False,False,False,False,False,False,False,False,False,False,False,False,False,False,False,False,False,False,False,52.0,32.0,48.0,52.0,73.0,78.0,27,30,80,60,32,47,27,28,60,60,51,52,43,71,46,42,81,73,84,22,69,72,33,50,41,53.0,75,70,71,8,10,13,12,10,,50+2,50+2,50+2,47,49,49,49,47,50+2,50+2,50+2,50+2,57+2,57+2,57+2,50+2,61+2,67+2,67+2,67+2,61+2,64+2,73+1,73+1,73+1,64+2,17+2,CB,193549,RCB|CB,71,71,1300000.0,9000.0,31,188,80,14.0,Right,3,2,1,Low/Medium,Normal (185+),False,False,False,False,False,False,False,False,False,False,False,False,False,False,False,False,False,False,False,False,False,False,False,False,False,False,False,False,False,False,False,False,False,False,False,False,False,False,False,False,False,False,False,False,47.0,29.0,50.0,53.0,72.0,78.0,46,22,74,50,18,53,49,35,58,50,41,52,50,69,49,54,82,66,83,23,78,75,23,53,25,56.0,69,72,71,8,10,12,13,16,,46+2,46+2,46+2,45,45,45,45,45,46+2,46+2,46+2,48+2,53+2,53+2,53+2,48+2,61+2,65+2,65+2,65+2,61+2,63+2,71,71,71,63+2,18+2,CB,193185,LB|LWB,71,71,1400000.0,9000.0,31,189,75,14.0,Left,3,3,1,High/Medium,Lean (185+),False,False,False,False,False,False,False,False,False,False,False,False,False,False,False,False,False,False,False,False,False,False,False,False,False,False,False,False,False,False,False,False,False,False,False,False,False,False,False,False,False,False,False,False,72.0,63.0,63.0,70.0,65.0,71.0,70,59,57,65,58,71,46,63,64,69,68,75,70,69,65,69,71,80,69,67,66,69,66,58,64,64.0,64,67,65,12,9,11,9,7,,66+2,66+2,66+2,67,66,66,66,67,66+2,66+2,66+2,68+2,66+2,66+2,66+2,68+2,69+2,67+2,67+2,67+2,69+2,68+2,66+2,66+2,66+2,68+2,16+2,LWB,216270,CDM|CM,71,71,2000000.0,10000.0,27,173,72,14.0,Right,3,3,1,High/High,Normal (170-185),False,False,False,False,False,False,False,False,False,False,False,False,False,False,False,False,False,False,False,False,False,False,False,False,False,False,False,False,False,False,False,False,False,False,False,False,False,False,False,False,False,False,False,False,72.0,65.0,71.0,70.0,65.0,74.0,70,67,48,72,55,69,69,66,70,70,69,75,73,70,80,66,59,91,66,60,74,64,70,75,64,69.0,65,70,67,11,15,16,10,8,,66+2,66+2,66+2,70,69,69,69,70,70+1,70+1,70+1,72-1,71,71,71,72-1,71,70+1,70+1,70+1,71,70+1,66+2,66+2,66+2,70+1,18+2,CM,200689,CDM|CM,70,70,1300000.0,8000.0,30,185,82,14.0,Right,3,3,1,High/High,Normal (185+),False,False,False,False,False,False,False,False,False,False,False,False,False,False,False,False,False,False,False,False,False,False,False,False,False,False,False,False,False,False,False,False,False,False,False,False,False,False,False,False,False,False,False,False,77.0,65.0,65.0,67.0,67.0,78.0,61,58,60,70,68,66,55,55,68,64,75,78,78,70,69,80,79,84,79,68,70,66,61,65,53,65.0,67,68,70,10,14,9,8,13,,67+2,67+2,67+2,66,67,67,67,66,67+2,67+2,67+2,67+2,68+2,68+2,68+2,67+2,70,69+1,69+1,69+1,70,69+1,69+1,69+1,69+1,69+1,18+2,CDM,204412,CDM|CM,70,70,1600000.0,9000.0,29,182,73,14.0,Left,3,3,1,Medium/Medium,Lean (170-185),False,False,False,False,False,False,False,False,False,False,False,False,False,False,False,False,False,False,False,False,False,False,False,False,False,False,False,False,False,False,False,False,False,False,False,False,False,False,False,False,False,False,False,False,63.0,66.0,69.0,69.0,68.0,74.0,69,67,67,70,56,67,64,68,66,70,65,61,71,72,71,66,83,85,66,68,77,69,69,72,54,64.0,66,70,64,7,11,12,11,14,,67+2,67+2,67+2,68,68,68,68,68,69+1,69+1,69+1,69+1,70,70,70,69+1,70,70,70,70,70,69+1,69+1,69+1,69+1,69+1,18+2,CM,239373,CAM|CF,73,77,4400000.0,11000.0,23,185,84,14.0,Right,4,3,1,High/Medium,Normal (185+),False,False,False,False,False,False,False,False,False,False,False,False,False,False,False,False,False,False,False,False,False,False,False,False,False,False,False,False,False,False,False,False,False,False,False,False,False,False,False,False,False,False,False,False,71.0,74.0,71.0,72.0,56.0,78.0,60,74,71,74,66,71,75,75,70,75,69,73,66,73,69,78,72,82,77,75,77,46,76,73,68,74.0,58,59,50,13,7,7,8,9,,74+2,74+2,74+2,72,74,74,74,72,73+2,73+2,73+2,72+2,72+2,72+2,72+2,72+2,64+2,66+2,66+2,66+2,64+2,63+2,63+2,63+2,63+2,63+2,16+2,CAM,211891,CF|ST,73,73,3000000.0,14000.0,30,178,83,14.0,Right,3,3,1,High/Medium,Stocky (170-185),False,False,False,False,False,False,False,False,False,False,False,False,False,False,False,False,False,False,False,False,False,False,False,False,False,False,False,False,False,False,False,False,False,False,False,False,False,False,False,False,False,False,False,False,79.0,74.0,65.0,69.0,38.0,80.0,64,72,71,67,69,68,69,68,53,69,72,85,65,71,80,85,86,66,85,70,82,31,72,69,69,69.0,39,34,23,12,9,7,14,8,,73,73,73,70,71,71,71,70,69+2,69+2,69+2,69+2,63+2,63+2,63+2,69+2,55+2,54+2,54+2,54+2,55+2,52+2,53+2,53+2,53+2,52+2,17+2,ST,198437,CF|ST,69,69,1400000.0,9000.0,29,178,71,14.0,Right,3,3,1,High/Medium,Normal (170-185),False,False,False,False,False,False,False,False,False,False,False,False,False,False,False,False,False,False,False,False,False,False,False,False,False,False,False,False,False,False,False,False,False,False,False,False,False,False,False,False,False,False,False,False,78.0,68.0,51.0,68.0,30.0,68.0,45,71,69,63,63,63,38,37,45,69,78,78,84,68,81,68,80,82,71,62,42,20,72,46,70,66.0,30,24,31,12,12,16,11,14,,69,69,69,66,67,67,67,66,64+2,64+2,64+2,64+2,57+2,57+2,57+2,64+2,51+2,47+2,47+2,47+2,51+2,49+2,44+2,44+2,44+2,49+2,19+2,ST
34,1960.0,2022.0,3-5-2,to_be_implemented,234260,GK,65,73,1400000.0,5000.0,24,183,73,14.0,Right,3,1,1,Medium/Medium,Normal (170-185),False,False,False,False,False,False,False,False,False,False,False,False,False,False,False,False,False,False,False,False,False,False,False,False,False,False,False,False,False,False,False,False,False,False,False,False,False,False,False,False,False,False,False,False,,,,,,,12,5,13,43,7,20,15,11,40,35,36,31,41,61,43,50,47,34,42,5,25,16,6,48,11,63.0,25,10,14,65,63,67,64,67,34.0,25+2,25+2,25+2,27,29,29,29,27,32+2,32+2,32+2,30+2,34+2,34+2,34+2,30+2,27+2,31+2,31+2,31+2,27+2,26+2,25+2,25+2,25+2,26+2,64+2,GK,186598,RCB|CB,70,70,750000.0,15000.0,33,179,73,14.0,Right,3,2,1,Medium/Medium,Lean (170-185),False,False,False,False,False,False,False,False,False,False,False,False,False,False,False,False,False,False,False,False,False,False,False,False,False,False,False,False,False,False,False,False,False,False,False,False,False,False,False,False,False,False,False,False,58.0,52.0,64.0,67.0,71.0,66.0,67,45,68,72,52,65,43,30,66,68,62,55,71,70,70,68,73,60,67,50,68,67,54,59,47,67.0,74,71,71,12,10,9,9,11,,60+2,60+2,60+2,62,61,61,61,62,63+2,63+2,63+2,63+2,65+2,65+2,65+2,63+2,67+2,69+1,69+1,69+1,67+2,68+2,70,70,70,68+2,17+2,CB,248687,CB,70,80,3300000.0,13000.0,22,188,81,14.0,Right,2,2,1,Medium/Medium,Normal (185+),False,False,False,False,False,False,False,False,False,False,False,False,False,False,False,False,False,False,False,False,False,False,False,False,False,False,False,False,False,False,False,False,False,False,False,False,False,False,False,False,False,False,False,False,64.0,28.0,42.0,48.0,71.0,73.0,31,24,68,60,26,38,29,25,39,56,60,67,45,71,57,36,77,63,79,26,70,72,27,29,38,55.0,68,73,70,8,11,7,9,9,,46+2,46+2,46+2,44,45,45,45,44,45+2,45+2,45+2,47+2,49+2,49+2,49+2,47+2,61+2,63+2,63+2,63+2,61+2,64+2,70+2,70+2,70+2,64+2,16+2,CB,236551,LCB|CB,68,76,2500000.0,9000.0,22,189,82,14.0,Right,4,2,1,High/Medium,Lean (185+),False,False,False,False,False,False,False,False,False,False,False,False,False,False,False,False,False,False,False,False,False,False,False,False,False,False,False,False,False,False,False,False,False,False,False,False,False,False,False,False,False,False,False,False,69.0,45.0,55.0,60.0,67.0,75.0,36,40,67,65,33,60,45,36,62,60,68,70,52,65,66,53,81,78,78,52,64,66,49,56,40,66.0,68,66,65,14,9,14,13,7,,57+2,57+2,57+2,56,57,57,57,56,58+2,58+2,58+2,58+2,61+2,61+2,61+2,58+2,63+2,66+2,66+2,66+2,63+2,64+2,68+2,68+2,68+2,64+2,17+2,CB,259766,RM|RWB|RB,62,77,900000.0,4000.0,19,173,73,14.0,Right,3,2,1,High/Medium,Lean (170-185),False,False,False,False,False,False,False,False,False,False,False,False,False,False,False,False,False,False,False,False,False,False,False,False,False,False,False,False,False,False,False,False,False,False,False,False,False,False,False,False,False,False,False,False,63.0,44.0,58.0,62.0,57.0,64.0,64,43,44,60,31,61,53,38,59,62,65,62,65,56,74,50,65,66,63,42,64,57,57,54,33,62.0,62,57,52,10,11,6,11,14,,53+2,53+2,53+2,58,56,56,56,58,57+2,57+2,57+2,60+2,58+2,58+2,58+2,60+2,60+2,59+2,59+2,59+2,60+2,59+2,58+2,58+2,58+2,59+2,16+2,RWB,212118,CDM|CM,73,74,3600000.0,23000.0,26,179,70,14.0,Left,5,3,1,Medium/High,Lean (170-185),False,False,False,False,False,False,False,False,False,False,False,False,False,False,False,False,False,False,False,False,False,False,False,False,False,False,False,False,False,False,False,False,False,False,False,False,False,False,False,False,False,False,False,False,62.0,59.0,75.0,71.0,65.0,67.0,73,52,39,79,49,68,72,68,76,73,60,63,77,74,76,69,64,91,56,66,64,71,53,73,60,65.0,63,72,68,16,15,6,7,15,,60+2,60+2,60+2,67,66,66,66,67,69+2,69+2,69+2,70+2,73+1,73+1,73+1,70+2,73+1,73+1,73+1,73+1,73+1,70+2,65+2,65+2,65+2,70+2,20+2,CM,184716,CDM|CM,71,71,1200000.0,17000.0,32,168,62,14.0,Right,2,3,1,Medium/High,Lean (170-),False,False,False,False,False,False,False,False,False,False,False,False,False,False,False,False,False,False,False,False,False,False,False,False,False,False,False,False,False,False,False,False,False,False,False,False,False,False,False,False,False,False,False,False,64.0,61.0,68.0,72.0,69.0,63.0,67,60,52,73,54,68,66,59,71,71,67,61,82,68,91,67,81,77,51,56,72,71,67,63,60,76.0,71,71,69,10,13,12,6,8,,63+2,63+2,63+2,67,66,66,66,67,68+2,68+2,68+2,68+2,69+2,69+2,69+2,68+2,70+1,70+1,70+1,70+1,70+1,69+2,67+2,67+2,67+2,69+2,16+2,CDM,218745,CDM|CM,71,72,2200000.0,18000.0,26,180,80,14.0,Right,3,3,1,Medium/Medium,Normal (170-185),False,False,False,False,False,False,False,False,False,False,False,False,False,False,False,False,False,False,False,False,False,False,False,False,False,False,False,False,False,False,False,False,False,False,False,False,False,False,False,False,False,False,False,False,67.0,68.0,72.0,75.0,63.0,73.0,68,63,51,74,66,75,73,70,72,77,69,65,77,59,79,77,74,73,76,72,66,65,68,75,72,77.0,66,63,60,8,14,14,6,6,,68+2,68+2,68+2,71,70,70,70,71,72,72,72,71+1,71+1,71+1,71+1,71+1,67+2,69+2,69+2,69+2,67+2,66+2,65+2,65+2,65+2,66+2,14+2,CM,226012,LM|LWB|LB,71,73,2100000.0,17000.0,26,173,72,14.0,Left,3,3,1,Medium/Medium,Normal (170-185),False,False,False,False,False,False,False,False,False,False,False,False,False,False,False,False,False,False,False,False,False,False,False,False,False,False,False,False,False,False,False,False,False,False,False,False,False,False,False,False,False,False,False,False,67.0,60.0,67.0,71.0,67.0,69.0,68,58,57,67,36,71,65,65,65,70,66,67,73,69,78,63,76,81,63,63,68,71,64,70,66,64.0,66,68,65,12,6,11,12,12,,63+2,63+2,63+2,67,66,66,66,67,67+2,67+2,67+2,68+2,69+2,69+2,69+2,68+2,69+2,69+2,69+2,69+2,69+2,68+2,67+2,67+2,67+2,68+2,17+2,LWB,247249,CF|ST,73,80,6000000.0,22000.0,22,185,74,14.0,Left,4,3,1,Medium/Medium,Normal (185+),False,False,False,False,False,False,False,False,False,False,False,False,False,False,False,False,False,False,False,False,False,False,False,False,False,False,False,False,False,False,False,False,False,False,False,False,False,False,False,False,False,False,False,False,66.0,75.0,61.0,68.0,29.0,71.0,47,76,70,70,66,66,55,54,55,72,63,69,65,72,63,77,71,69,83,75,45,21,76,66,72,74.0,20,29,27,10,13,9,7,11,,73+2,73+2,73+2,68,71,71,71,68,70+2,70+2,70+2,67+2,64+2,64+2,64+2,67+2,50+2,49+2,49+2,49+2,50+2,47+2,45+2,45+2,45+2,47+2,17+2,ST,242265,CF|ST,70,77,3300000.0,13000.0,21,169,71,14.0,Right,3,2,1,High/Medium,Stocky (170-),False,False,False,False,False,False,False,False,False,False,False,False,False,False,False,False,False,False,False,False,False,False,False,False,False,False,False,False,False,False,False,False,False,False,False,False,False,False,False,False,False,False,False,False,81.0,69.0,56.0,71.0,23.0,64.0,50,72,64,64,63,69,58,41,44,68,85,78,82,70,89,71,69,61,66,61,60,13,69,61,67,66.0,18,23,15,11,11,13,12,9,,70+2,70+2,70+2,68,69,69,69,68,67+2,67+2,67+2,66+2,58+2,58+2,58+2,66+2,47+2,44+2,44+2,44+2,47+2,44+2,40+2,40+2,40+2,44+2,17+2,ST
35,1939.0,2022.0,3-5-2,to_be_implemented,198285,GK,72,74,1900000.0,12000.0,29,191,85,14.0,Right,3,1,1,Medium/Medium,Normal (185+),False,False,False,False,False,False,False,False,False,False,False,False,False,False,False,False,False,False,False,False,False,False,False,False,False,False,False,False,False,False,False,False,False,False,False,False,False,False,False,False,False,False,False,False,,,,,,,18,11,15,39,10,12,11,15,41,29,40,42,42,62,40,52,67,29,55,14,26,9,5,50,23,44.0,12,11,13,73,71,69,73,74,41.0,27+2,27+2,27+2,27,29,29,29,27,31+2,31+2,31+2,29+2,32+2,32+2,32+2,29+2,25+2,28+2,28+2,28+2,25+2,24+2,24+2,24+2,24+2,24+2,71+2,GK,219293,RCB|CB,71,72,1900000.0,12000.0,26,191,80,14.0,Right,3,2,1,Medium/Medium,Normal (185+),False,False,False,False,False,False,False,False,False,False,False,False,False,False,False,False,False,False,False,False,False,False,False,False,False,False,False,False,False,False,False,False,False,False,False,False,False,False,False,False,False,False,False,False,62.0,49.0,47.0,53.0,70.0,76.0,41,52,73,61,49,46,29,40,51,59,59,64,53,70,59,52,91,71,79,41,72,74,61,34,37,55.0,69,69,65,14,10,9,12,7,,59+2,59+2,59+2,54,55,55,55,54,53+2,53+2,53+2,55+2,56+2,56+2,56+2,55+2,63+2,65+2,65+2,65+2,63+2,65+2,71+1,71+1,71+1,65+2,17+2,CB,193569,CB,70,70,1100000.0,11000.0,31,185,75,14.0,Right,2,2,1,Low/Medium,Normal (185+),False,False,False,False,False,False,False,False,False,False,False,False,False,False,False,False,False,False,False,False,False,False,False,False,False,False,False,False,False,False,False,False,False,False,False,False,False,False,False,False,False,False,False,False,54.0,36.0,55.0,62.0,71.0,74.0,53,36,71,62,20,59,33,20,59,62,55,53,61,70,67,38,80,67,80,35,66,70,38,57,42,73.0,71,71,70,13,14,14,9,15,,52+2,52+2,52+2,54,53,53,53,54,55+2,55+2,55+2,56+2,60+2,60+2,60+2,56+2,64+2,67+2,67+2,67+2,64+2,65+2,70,70,70,65+2,19+2,CB,208014,LCB|CB,70,71,1500000.0,11000.0,28,190,78,14.0,Right,3,2,1,Medium/High,Normal (185+),False,False,False,False,False,False,False,False,False,False,False,False,False,False,False,False,False,False,False,False,False,False,False,False,False,False,False,False,False,False,False,False,False,False,False,False,False,False,False,False,False,False,False,False,55.0,43.0,50.0,55.0,70.0,77.0,52,42,75,60,35,51,39,30,58,55,53,57,57,67,61,53,67,76,81,38,71,69,35,34,43,59.0,67,72,68,15,8,12,13,15,,53+2,53+2,53+2,50,50,50,50,50,50+2,50+2,50+2,53+2,55+2,55+2,55+2,53+2,63+2,65+2,65+2,65+2,63+2,65+2,70+1,70+1,70+1,65+2,19+2,CB,203292,RM|RWB|RB,67,67,900000.0,7000.0,29,180,75,14.0,Right,3,2,1,Medium/High,Normal (170-185),False,False,False,False,False,False,False,False,False,False,False,False,False,False,False,False,False,False,False,False,False,False,False,False,False,False,False,False,False,False,False,False,False,False,False,False,False,False,False,False,False,False,False,False,64.0,43.0,60.0,62.0,63.0,69.0,62,48,56,64,19,57,40,35,62,61,65,64,78,60,73,45,63,86,69,31,49,62,55,59,46,64.0,64,65,63,8,15,9,10,14,,55+2,55+2,55+2,58,57,57,57,58,58+2,58+2,58+2,61+2,61+2,61+2,61+2,61+2,65+2,64+2,64+2,64+2,65+2,65+2,62+2,62+2,62+2,65+2,17+2,RB,183546,CDM|CM,70,70,800000.0,11000.0,33,176,73,14.0,Right,3,2,1,Low/High,Normal (170-185),False,False,False,False,False,False,False,False,False,False,False,False,False,False,False,False,False,False,False,False,False,False,False,False,False,False,False,False,False,False,False,False,False,False,False,False,False,False,False,False,False,False,False,False,58.0,53.0,61.0,66.0,69.0,76.0,56,51,64,72,47,64,46,41,63,67,62,55,64,66,72,64,82,76,72,50,84,69,54,54,41,69.0,68,73,67,6,8,13,14,11,,60+2,60+2,60+2,61,61,61,61,61,62+2,62+2,62+2,62+2,65+2,65+2,65+2,62+2,67+2,69+1,69+1,69+1,67+2,67+2,70,70,70,67+2,16+2,CDM,242436,CDM|CM,66,76,1800000.0,4000.0,21,194,81,14.0,Right,3,2,1,Medium/Medium,Normal (185+),False,False,False,False,False,False,False,False,False,False,False,False,False,False,False,False,False,False,False,False,False,False,False,False,False,False,False,False,False,False,False,False,False,False,False,False,False,False,False,False,False,False,False,False,64.0,58.0,60.0,64.0,63.0,74.0,48,61,63,69,53,66,49,44,63,66,62,65,57,64,53,58,59,63,82,52,69,59,62,63,46,62.0,62,65,63,8,10,10,10,15,,63+2,63+2,63+2,62,64,64,64,62,64+2,64+2,64+2,63+2,64+2,64+2,64+2,63+2,62+2,65+2,65+2,65+2,62+2,62+2,65+2,65+2,65+2,62+2,17+2,CDM,233938,CDM|CM,65,74,1600000.0,5000.0,22,180,70,14.0,Right,3,3,1,Medium/High,Lean (170-185),False,False,False,False,False,False,False,False,False,False,False,False,False,False,False,False,False,False,False,False,False,False,False,False,False,False,False,False,False,False,False,False,False,False,False,False,False,False,False,False,False,False,False,False,70.0,52.0,62.0,68.0,63.0,66.0,54,50,50,67,48,66,53,44,64,67,74,66,79,64,72,55,57,73,60,56,75,62,58,64,48,65.0,65,65,64,12,10,11,14,13,,59+2,59+2,59+2,63,62,62,62,63,64+2,64+2,64+2,64+2,65+2,65+2,65+2,64+2,65+2,66+2,66+2,66+2,65+2,64+2,63+2,63+2,63+2,64+2,18+2,CM,202528,LM|LWB|LB,68,68,1100000.0,8000.0,28,178,75,14.0,Left,2,2,1,Medium/Medium,Normal (170-185),False,False,False,False,False,False,False,False,False,False,False,False,False,False,False,False,False,False,False,False,False,False,False,False,False,False,False,False,False,False,False,False,False,False,False,False,False,False,False,False,False,False,False,False,66.0,51.0,62.0,64.0,64.0,68.0,65,50,63,62,41,62,55,60,61,63,63,69,73,65,70,57,66,83,66,48,54,66,57,62,42,65.0,65,63,63,12,9,10,14,10,,59+2,59+2,59+2,61,60,60,60,61,61+2,61+2,61+2,63+2,63+2,63+2,63+2,63+2,66+2,64+2,64+2,64+2,66+2,66+2,64+2,64+2,64+2,66+2,17+2,LWB,194319,CF|ST,70,70,1300000.0,13000.0,31,180,72,14.0,Left,4,3,1,High/High,Normal (170-185),False,False,False,False,False,False,False,False,False,False,False,False,False,False,False,False,False,False,False,False,False,False,False,False,False,False,False,False,False,False,False,False,False,False,False,False,False,False,False,False,False,False,False,False,68.0,72.0,62.0,67.0,38.0,71.0,62,71,70,64,68,67,60,60,59,66,71,65,69,68,68,77,86,72,72,70,62,23,69,64,67,64.0,41,37,32,13,11,15,11,8,,70,70,70,67,68,68,68,67,66+2,66+2,66+2,66+2,62+2,62+2,62+2,66+2,53+2,52+2,52+2,52+2,53+2,51+2,50+2,50+2,50+2,51+2,17+2,ST,184624,CF|ST,68,68,975000.0,9000.0,32,185,71,14.0,Right,2,2,1,Medium/Low,Normal (185+),False,False,False,False,False,False,False,False,False,False,False,False,False,False,False,False,False,False,False,False,False,False,False,False,False,False,False,False,False,False,False,False,False,False,False,False,False,False,False,False,False,False,False,False,62.0,70.0,53.0,62.0,39.0,60.0,56,73,74,52,72,55,46,39,40,67,53,69,65,71,65,70,76,53,72,59,34,42,73,67,72,75.0,35,35,26,10,8,14,11,10,,68,68,68,63,65,65,65,63,62+2,62+2,62+2,61+2,57+2,57+2,57+2,61+2,50+2,48+2,48+2,48+2,50+2,49+2,48+2,48+2,48+2,49+2,17+2,ST
36,1806.0,2022.0,4-3-1-2,to_be_implemented,240784,GK,68,79,2300000.0,6000.0,21,187,75,14.0,Left,2,1,1,Medium/Medium,Normal (185+),False,False,False,False,False,False,False,False,False,False,False,False,False,False,False,False,False,False,False,False,False,False,False,False,False,False,False,False,False,False,False,False,False,False,False,False,False,False,False,False,False,False,False,False,,,,,,,36,20,11,38,20,21,60,53,42,31,40,40,40,65,63,50,69,35,59,20,30,19,4,36,53,41.0,20,12,14,67,66,66,65,69,40.0,29+2,29+2,29+2,31,30,30,30,31,31+2,31+2,31+2,33+2,33+2,33+2,33+2,33+2,30+2,31+2,31+2,31+2,30+2,28+2,27+2,27+2,27+2,28+2,67+2,GK,238071,RB|RWB,68,77,2600000.0,25000.0,22,186,81,14.0,Right,3,3,1,Medium/Medium,Lean (185+),False,False,False,False,False,False,False,False,False,False,False,False,False,False,False,False,False,False,False,False,False,False,False,False,False,False,False,False,False,False,False,False,False,False,False,False,False,False,False,False,False,False,False,False,76.0,48.0,57.0,64.0,65.0,69.0,66,50,58,60,29,67,48,34,48,61,77,76,69,63,58,53,64,65,74,42,64,66,52,59,43,61.0,64,65,68,11,8,8,7,5,,58+2,58+2,58+2,62,60,60,60,62,60+2,60+2,60+2,62+2,59+2,59+2,59+2,62+2,66+2,62+2,62+2,62+2,66+2,66+2,65+2,65+2,65+2,66+2,14+2,RWB,229901,LCB|CB,72,77,3200000.0,16000.0,23,200,79,14.0,Right,3,2,1,Medium/High,Normal (185+),False,False,False,False,False,False,False,False,False,False,False,False,False,False,False,False,False,False,False,False,False,False,False,False,False,False,False,False,False,False,False,False,False,False,False,False,False,False,False,False,False,False,False,False,39.0,28.0,50.0,58.0,73.0,76.0,24,25,72,66,23,56,26,31,63,63,37,40,57,71,30,33,70,66,86,26,64,73,26,50,40,62.0,73,72,73,12,12,12,15,13,,47+2,47+2,47+2,46,48,48,48,46,52+2,52+2,52+2,50+2,59+2,59+2,59+2,50+2,61+2,68+2,68+2,68+2,61+2,62+2,72+2,72+2,72+2,62+2,19+2,CB,202408,RCB|CB,71,71,1200000.0,17000.0,32,197,83,14.0,Right,3,2,1,Medium/Medium,Normal (185+),False,False,False,False,False,False,False,False,False,False,False,False,False,False,False,False,False,False,False,False,False,False,False,False,False,False,False,False,False,False,False,False,False,False,False,False,False,False,False,False,False,False,False,False,41.0,48.0,40.0,41.0,69.0,82.0,21,52,81,51,38,33,24,25,50,52,35,46,30,67,27,63,74,66,90,26,82,67,54,42,36,55.0,68,68,68,13,10,8,10,11,,56+2,56+2,56+2,43,49,49,49,43,46+2,46+2,46+2,46+2,52+2,52+2,52+2,46+2,55+2,62+2,62+2,62+2,55+2,58+2,71,71,71,58+2,17+2,CB,232759,LB|LWB,70,77,3000000.0,13000.0,23,180,75,14.0,Left,3,2,1,Medium/Medium,Normal (170-185),False,False,False,False,False,False,False,False,False,False,False,False,False,False,False,False,False,False,False,False,False,False,False,False,False,False,False,False,False,False,False,False,False,False,False,False,False,False,False,False,False,False,False,False,75.0,52.0,67.0,66.0,62.0,70.0,74,48,56,65,37,66,72,57,65,65,75,75,67,64,70,66,68,80,66,54,70,64,55,66,40,60.0,63,64,59,13,13,9,12,11,,60+2,60+2,60+2,64,62,62,62,64,63+2,63+2,63+2,66+2,65+2,65+2,65+2,66+2,68+2,65+2,65+2,65+2,68+2,67+2,64+2,64+2,64+2,67+2,18+2,LWB,211504,CDM|CM,72,73,2700000.0,21000.0,27,182,72,14.0,Right,5,3,1,High/Medium,Lean (170-185),False,False,False,False,False,False,False,False,False,False,False,False,False,False,False,False,False,False,False,False,False,False,False,False,False,False,False,False,False,False,False,False,False,False,False,False,False,False,False,False,False,False,False,False,66.0,69.0,72.0,72.0,66.0,71.0,70,63,58,73,71,70,74,74,73,75,67,66,72,70,71,77,62,76,69,73,72,67,65,72,76,71.0,68,67,61,8,15,12,8,6,,68+2,68+2,68+2,70,70,70,70,70,71+2,71+2,71+2,70+2,72+1,72+1,72+1,70+2,69+2,70+2,70+2,70+2,69+2,68+2,67+2,67+2,67+2,68+2,16+2,CM,234457,CDM|CM,72,74,2600000.0,19000.0,26,176,70,14.0,Right,4,3,1,High/High,Lean (170-185),False,False,False,False,False,False,False,False,False,False,False,False,False,False,False,False,False,False,False,False,False,False,False,False,False,False,False,False,False,False,False,False,False,False,False,False,False,False,False,False,False,False,False,False,71.0,65.0,67.0,73.0,70.0,77.0,60,59,66,72,66,71,62,66,68,73,74,69,84,69,74,80,85,79,75,62,79,67,65,65,69,68.0,70,72,70,10,12,13,12,15,,68+2,68+2,68+2,68,69,69,69,68,69+2,69+2,69+2,69+2,69+2,69+2,69+2,69+2,70+2,71+2,71+2,71+2,70+2,70+2,71+2,71+2,71+2,70+2,19+2,CDM,193884,CDM|CM,71,71,1500000.0,18000.0,31,188,74,14.0,Left,4,3,1,Medium/Medium,Lean (185+),False,False,False,False,False,False,False,False,False,False,False,False,False,False,False,False,False,False,False,False,False,False,False,False,False,False,False,False,False,False,False,False,False,False,False,False,False,False,False,False,False,False,False,False,66.0,70.0,71.0,69.0,66.0,72.0,71,70,62,72,68,70,69,67,68,71,62,69,66,71,63,70,72,86,70,74,61,69,68,72,65,67.0,67,68,58,6,9,9,8,6,,69+2,69+2,69+2,70,70,70,70,70,70+1,70+1,70+1,71,71,71,71,71,70+1,70+1,70+1,70+1,70+1,69+2,67+2,67+2,67+2,69+2,14+2,CM,201093,CAM|CF,72,72,2400000.0,22000.0,28,183,65,14.0,Right,4,3,1,Medium/High,Lean (170-185),False,False,False,False,False,False,False,False,False,False,False,False,False,False,False,False,False,False,False,False,False,False,False,False,False,False,False,False,False,False,False,False,False,False,False,False,False,False,False,False,False,False,False,False,67.0,72.0,70.0,72.0,54.0,67.0,64,72,77,70,63,71,72,71,70,74,69,65,71,74,74,73,84,67,68,72,60,45,74,74,70,73.0,55,54,49,15,13,7,14,12,,72,72,72,71,72,72,72,71,72,72,72,71+1,70+2,70+2,70+2,71+1,62+2,62+2,62+2,62+2,62+2,61+2,60+2,60+2,60+2,61+2,20+2,CAM,205670,CF|ST,72,72,2000000.0,23000.0,31,174,78,14.0,Right,4,3,1,Medium/Low,Lean (170-185),False,False,False,False,False,False,False,False,False,False,False,False,False,False,False,False,False,False,False,False,False,False,False,False,False,False,False,False,False,False,False,False,False,False,False,False,False,False,False,False,False,False,False,False,75.0,73.0,58.0,73.0,28.0,57.0,59,74,68,64,70,71,54,71,53,73,76,74,77,72,80,76,73,52,62,69,46,35,77,48,73,71.0,20,24,14,10,7,16,8,8,,72,72,72,70,71,71,71,70,67+2,67+2,67+2,67+2,60+2,60+2,60+2,67+2,50+2,47+2,47+2,47+2,50+2,47+2,42+2,42+2,42+2,47+2,16+2,ST,236650,CF|ST,70,75,2400000.0,15000.0,24,184,72,14.0,Right,3,3,1,High/High,Lean (170-185),False,False,False,False,False,False,False,False,False,False,False,False,False,False,False,False,False,False,False,False,False,False,False,False,False,False,False,False,False,False,False,False,False,False,False,False,False,False,False,False,False,False,False,False,75.0,69.0,62.0,69.0,48.0,73.0,65,72,70,65,61,68,58,47,55,68,74,75,74,68,72,72,85,84,69,66,64,44,68,66,58,68.0,42,50,43,6,14,7,6,14,,70+2,70+2,70+2,69,69,69,69,69,68+2,68+2,68+2,68+2,64+2,64+2,64+2,68+2,61+2,58+2,58+2,58+2,61+2,59+2,56+2,56+2,56+2,59+2,16+2,ST
37,1923.0,2022.0,4-3-1-2,to_be_implemented,219736,GK,71,74,1800000.0,25000.0,27,195,83,14.0,Right,3,1,1,Medium/Medium,Normal (185+),False,False,False,False,False,False,False,False,False,False,False,False,False,False,False,False,False,False,False,False,False,False,False,False,False,False,False,False,False,False,False,False,False,False,False,False,False,False,False,False,False,False,False,False,,,,,,,11,17,13,31,14,16,16,17,30,22,48,49,54,72,32,43,64,30,64,19,27,10,11,50,11,31.0,14,9,8,78,66,57,62,76,48.0,29+2,29+2,29+2,29,30,30,30,29,32+2,32+2,32+2,30+2,30+2,30+2,30+2,30+2,24+2,26+2,26+2,26+2,24+2,24+2,24+2,24+2,24+2,24+2,70+2,GK,222156,RB|RWB,71,75,2500000.0,17000.0,24,178,74,14.0,Right,3,2,1,High/Medium,Normal (170-185),False,False,False,False,False,False,False,False,False,False,False,False,False,False,False,False,False,False,False,False,False,False,False,False,False,False,False,False,False,False,False,False,False,False,False,False,False,False,False,False,False,False,False,False,73.0,44.0,64.0,66.0,67.0,67.0,72,38,59,65,36,67,60,68,60,68,73,73,66,65,61,54,62,75,68,43,54,67,61,55,43,56.0,69,69,66,14,9,9,16,7,,58+2,58+2,58+2,63,61,61,61,63,61+2,61+2,61+2,65+2,63+2,63+2,63+2,65+2,69+2,66+2,66+2,66+2,69+2,69+2,66+2,66+2,66+2,69+2,17+2,RWB,203749,LCB|CB,70,70,1300000.0,17000.0,30,196,90,14.0,Left,3,2,1,Medium/High,Normal (185+),False,False,False,False,False,False,False,False,False,False,False,False,False,False,False,False,False,False,False,False,False,False,False,False,False,False,False,False,False,False,False,False,False,False,False,False,False,False,False,False,False,False,False,False,54.0,31.0,47.0,51.0,69.0,76.0,36,28,71,62,26,44,20,22,53,56,55,54,61,66,34,40,69,67,81,29,75,69,41,40,19,62.0,70,69,68,13,15,9,9,9,,49+2,49+2,49+2,47,48,48,48,47,49+2,49+2,49+2,50+2,54+2,54+2,54+2,50+2,60+2,64+2,64+2,64+2,60+2,63+2,70,70,70,63+2,17+2,CB,211363,RCB|CB,70,70,1500000.0,17000.0,27,185,72,14.0,Right,4,2,1,Medium/High,Normal (185+),False,False,False,False,False,False,False,False,False,False,False,False,False,False,False,False,False,False,False,False,False,False,False,False,False,False,False,False,False,False,False,False,False,False,False,False,False,False,False,False,False,False,False,False,66.0,36.0,54.0,60.0,69.0,78.0,45,38,70,62,21,55,44,30,62,63,68,64,68,64,64,37,79,77,79,34,76,68,38,49,39,62.0,68,71,66,15,13,14,9,7,,52+2,52+2,52+2,54,53,53,53,54,55+2,55+2,55+2,57+2,59+2,59+2,59+2,57+2,64+2,67+2,67+2,67+2,64+2,65+2,70,70,70,65+2,17+2,CB,207804,LB|LWB,70,70,1400000.0,18000.0,28,180,77,14.0,Left,2,3,1,High/Medium,Normal (170-185),False,False,False,False,False,False,False,False,False,False,False,False,False,False,False,False,False,False,False,False,False,False,False,False,False,False,False,False,False,False,False,False,False,False,False,False,False,False,False,False,False,False,False,False,77.0,49.0,59.0,65.0,64.0,67.0,66,47,53,64,45,67,42,45,58,65,77,77,63,64,71,55,76,78,64,49,59,66,49,50,51,55.0,67,63,64,6,9,14,13,12,,58+2,58+2,58+2,62,60,60,60,62,60+2,60+2,60+2,64+2,61+2,61+2,61+2,64+2,68+2,64+2,64+2,64+2,68+2,67+2,64+2,64+2,64+2,67+2,16+2,LWB,207956,CDM|CM,70,70,1600000.0,20000.0,28,175,74,14.0,Right,3,3,1,Medium/High,Stocky (170-185),False,False,False,False,False,False,False,False,False,False,False,False,False,False,False,False,False,False,False,False,False,False,False,False,False,False,False,False,False,False,False,False,False,False,False,False,False,False,False,False,False,False,False,False,79.0,62.0,64.0,72.0,68.0,81.0,61,59,67,70,52,73,43,41,67,70,80,78,72,69,82,73,76,89,82,64,68,69,64,67,44,70.0,66,69,66,16,7,14,15,11,,68+2,68+2,68+2,69,69,69,69,69,69+1,69+1,69+1,70,70,70,70,70,71-1,70,70,70,71-1,70,70,70,70,70,19+2,CM,233484,CDM|CM,70,76,2500000.0,16000.0,23,175,74,14.0,Right,3,2,1,High/High,Normal (170-185),False,False,False,False,False,False,False,False,False,False,False,False,False,False,False,False,False,False,False,False,False,False,False,False,False,False,False,False,False,False,False,False,False,False,False,False,False,False,False,False,False,False,False,False,75.0,63.0,65.0,69.0,70.0,77.0,55,63,65,70,55,66,62,57,69,69,74,75,71,70,80,65,66,84,74,65,77,69,68,68,55,73.0,70,72,67,13,14,8,15,7,,67+2,67+2,67+2,67,68,68,68,67,68+2,68+2,68+2,68+2,70+2,70+2,70+2,68+2,70+2,71+2,71+2,71+2,70+2,70+2,70+2,70+2,70+2,70+2,18+2,CM,215570,CDM|CM,69,70,1400000.0,15000.0,27,184,73,14.0,Right,3,2,1,Medium/High,Normal (170-185),False,False,False,False,False,False,False,False,False,False,False,False,False,False,False,False,False,False,False,False,False,False,False,False,False,False,False,False,False,False,False,False,False,False,False,False,False,False,False,False,False,False,False,False,63.0,32.0,54.0,61.0,71.0,76.0,43,29,70,67,35,57,32,28,60,65,62,64,60,67,57,40,81,74,78,30,73,73,37,50,29,64.0,70,71,67,8,10,8,13,15,,51+2,51+2,51+2,53,53,53,53,53,55+2,55+2,55+2,56+2,60+2,60+2,60+2,56+2,65+2,68+2,68+2,68+2,65+2,66+2,71-1,71-1,71-1,66+2,17+2,CDM,169078,CAM|CF,69,69,1300000.0,16000.0,30,172,73,14.0,Left,2,3,1,Medium/Medium,Stocky (170-185),False,False,False,False,False,False,False,False,False,False,False,False,False,False,False,False,False,False,False,False,False,False,False,False,False,False,False,False,False,False,False,False,False,False,False,False,False,False,False,False,False,False,False,False,69.0,65.0,70.0,71.0,51.0,61.0,70,64,40,69,61,71,74,69,66,70,73,66,80,66,80,68,70,59,62,66,57,58,65,72,62,64.0,48,54,52,7,12,11,11,8,,64+2,64+2,64+2,69,68,68,68,69,69,69,69,68+1,67+2,67+2,67+2,68+1,62+2,61+2,61+2,61+2,62+2,60+2,56+2,56+2,56+2,60+2,16+2,CAM,229375,CF|ST,72,76,3400000.0,23000.0,24,193,89,14.0,Right,3,3,1,High/Medium,Normal (185+),False,False,False,False,False,False,False,False,False,False,False,False,False,False,False,False,False,False,False,False,False,False,False,False,False,False,False,False,False,False,False,False,False,False,False,False,False,False,False,False,False,False,False,False,73.0,71.0,50.0,68.0,44.0,79.0,43,74,72,55,63,68,54,46,42,70,68,77,67,71,59,72,70,77,85,66,71,39,74,55,65,63.0,42,43,34,6,11,9,11,11,,72+2,72+2,72+2,66,68,68,68,66,65+2,65+2,65+2,64+2,59+2,59+2,59+2,64+2,55+2,54+2,54+2,54+2,55+2,54+2,55+2,55+2,55+2,54+2,16+2,ST,216155,CF|ST,70,71,1900000.0,20000.0,27,180,84,14.0,Right,3,3,1,Medium/Medium,Normal (170-185),False,False,False,False,False,False,False,False,False,False,False,False,False,False,False,False,False,False,False,False,False,False,False,False,False,False,False,False,False,False,False,False,False,False,False,False,False,False,False,False,False,False,False,False,86.0,68.0,58.0,70.0,36.0,61.0,63,70,64,64,58,72,42,48,45,70,85,87,70,68,68,69,44,74,68,65,33,38,68,61,58,60.0,35,31,24,10,6,6,9,12,,70+1,70+1,70+1,70,70,70,70,70,68+2,68+2,68+2,69+2,61+2,61+2,61+2,69+2,56+2,50+2,50+2,50+2,56+2,53+2,45+2,45+2,45+2,53+2,16+2,ST
38,1961.0,2022.0,3-5-2,to_be_implemented,199812,GK,69,69,925000.0,12000.0,30,189,80,14.0,Right,3,1,1,Medium/Medium,Normal (185+),False,False,False,False,False,False,False,False,False,False,False,False,False,False,False,False,False,False,False,False,False,False,False,False,False,False,False,False,False,False,False,False,False,False,False,False,False,False,False,False,False,False,False,False,,,,,,,15,11,13,48,15,12,14,12,53,26,42,42,48,64,44,53,50,37,58,15,28,23,10,53,27,40.0,17,11,11,67,68,71,68,69,42.0,28+2,28+2,28+2,28,30,30,30,28,34+2,34+2,34+2,32+2,37+2,37+2,37+2,32+2,28+2,34+2,34+2,34+2,28+2,27+2,26+2,26+2,26+2,27+2,68+1,GK,235458,RCB|CB,69,73,1700000.0,14000.0,25,193,90,14.0,Right,2,2,1,Medium/High,Normal (185+),False,False,False,False,False,False,False,False,False,False,False,False,False,False,False,False,False,False,False,False,False,False,False,False,False,False,False,False,False,False,False,False,False,False,False,False,False,False,False,False,False,False,False,False,68.0,35.0,49.0,46.0,67.0,82.0,39,30,67,59,32,40,37,32,52,51,64,72,44,63,41,53,66,66,92,30,81,67,29,44,36,56.0,66,67,65,9,10,7,7,14,,49+2,49+2,49+2,46,47,47,47,46,47+2,47+2,47+2,49+2,52+2,52+2,52+2,49+2,60+2,63+2,63+2,63+2,60+2,62+2,69+2,69+2,69+2,62+2,16+2,CB,200840,CB,68,68,1000000.0,13000.0,29,183,74,14.0,Right,3,2,1,Medium/Medium,Lean (170-185),False,False,False,False,False,False,False,False,False,False,False,False,False,False,False,False,False,False,False,False,False,False,False,False,False,False,False,False,False,False,False,False,False,False,False,False,False,False,False,False,False,False,False,False,68.0,36.0,50.0,58.0,67.0,80.0,37,38,67,55,23,54,40,50,58,57,70,66,69,67,61,42,91,77,85,28,66,67,43,50,37,60.0,67,66,66,14,11,8,10,13,,53+2,53+2,53+2,52,52,52,52,52,53+2,53+2,53+2,55+2,56+2,56+2,56+2,55+2,62+2,64+2,64+2,64+2,62+2,63+2,68,68,68,63+2,18+2,CB,223905,LCB|CB,68,71,1400000.0,12000.0,26,180,77,14.0,Right,4,3,1,Medium/High,Lean (170-185),False,False,False,False,False,False,False,False,False,False,False,False,False,False,False,False,False,False,False,False,False,False,False,False,False,False,False,False,False,False,False,False,False,False,False,False,False,False,False,False,False,False,False,False,75.0,45.0,61.0,65.0,67.0,72.0,62,37,67,66,47,63,49,43,63,68,76,74,64,68,63,51,72,83,69,54,67,65,57,59,45,63.0,68,69,66,10,6,8,16,7,,59+2,59+2,59+2,62,61,61,61,62,62+2,62+2,62+2,64+2,64+2,64+2,64+2,64+2,69+2,67+2,67+2,67+2,69+2,69+2,68+2,68+2,68+2,69+2,16+2,CB,211966,RM|RWB|RB,68,69,1300000.0,12000.0,26,178,73,14.0,Right,3,2,1,High/Medium,Normal (170-185),False,False,False,False,False,False,False,False,False,False,False,False,False,False,False,False,False,False,False,False,False,False,False,False,False,False,False,False,False,False,False,False,False,False,False,False,False,False,False,False,False,False,False,False,81.0,47.0,61.0,65.0,62.0,69.0,64,47,57,63,29,64,55,35,60,61,80,82,80,57,72,57,76,80,67,39,60,63,61,63,48,60.0,62,63,62,8,13,12,15,7,,58+2,58+2,58+2,63,61,61,61,63,62+2,62+2,62+2,64+2,62+2,62+2,62+2,64+2,66+2,63+2,63+2,63+2,66+2,66+2,63+2,63+2,63+2,66+2,16+2,RB,192495,CDM|CM,71,71,1800000.0,22000.0,30,185,67,14.0,Right,3,3,1,Medium/High,Lean (185+),False,False,False,False,False,False,False,False,False,False,False,False,False,False,False,False,False,False,False,False,False,False,False,False,False,False,False,False,False,False,False,False,False,False,False,False,False,False,False,False,False,False,False,False,64.0,61.0,71.0,73.0,60.0,66.0,59,59,55,78,62,70,65,51,75,76,63,65,79,69,78,60,42,73,67,66,63,58,63,73,57,77.0,64,61,50,12,11,6,15,6,,65+2,65+2,65+2,68,68,68,68,68,71,71,71,69+2,71,71,71,69+2,65+2,68+2,68+2,68+2,65+2,63+2,61+2,61+2,61+2,63+2,17+2,CM,204464,CDM|CM,70,70,1600000.0,20000.0,28,178,70,14.0,Left,2,3,1,Medium/High,Normal (170-185),False,False,False,False,False,False,False,False,False,False,False,False,False,False,False,False,False,False,False,False,False,False,False,False,False,False,False,False,False,False,False,False,False,False,False,False,False,False,False,False,False,False,False,False,61.0,68.0,71.0,68.0,66.0,66.0,71,66,50,72,63,66,71,70,72,71,64,59,69,70,68,71,59,75,58,69,76,67,67,71,74,70.0,67,70,68,9,16,13,11,11,,65+2,65+2,65+2,68,68,68,68,68,69+1,69+1,69+1,69+1,70,70,70,69+1,69+1,70,70,70,69+1,68+2,66+2,66+2,66+2,68+2,18+2,CM,228517,CDM|CM,70,74,2000000.0,16000.0,25,175,72,14.0,Right,3,3,1,High/High,Normal (170-185),False,False,False,False,False,False,False,False,False,False,False,False,False,False,False,False,False,False,False,False,False,False,False,False,False,False,False,False,False,False,False,False,False,False,False,False,False,False,False,False,False,False,False,False,80.0,54.0,59.0,68.0,71.0,80.0,56,53,66,66,57,69,59,35,57,65,76,84,66,68,83,58,72,83,80,53,80,71,57,59,45,65.0,69,74,74,13,8,12,13,9,,63+2,63+2,63+2,64,64,64,64,64,64+2,64+2,64+2,66+2,65+2,65+2,65+2,66+2,71+2,69+2,69+2,69+2,71+2,71+2,72+2,72+2,72+2,71+2,17+2,CDM,241135,LM|LWB|LB,69,69,1300000.0,15000.0,27,183,73,14.0,Left,3,3,1,High/Medium,Normal (170-185),False,False,False,False,False,False,False,False,False,False,False,False,False,False,False,False,False,False,False,False,False,False,False,False,False,False,False,False,False,False,False,False,False,False,False,False,False,False,False,False,False,False,False,False,78.0,36.0,58.0,70.0,66.0,68.0,65,29,57,67,35,70,56,32,49,68,80,77,77,67,74,42,70,64,69,38,71,67,61,49,34,65.0,66,68,66,8,6,10,7,10,,56+2,56+2,56+2,63,60,60,60,63,61+2,61+2,61+2,64+2,60+2,60+2,60+2,64+2,68+1,65+2,65+2,65+2,68+1,67+2,67+2,67+2,67+2,67+2,14+2,LB,206518,CF|ST,71,71,2000000.0,24000.0,27,178,75,14.0,Right,3,3,1,Medium/Medium,Normal (170-185),False,False,False,False,False,False,False,False,False,False,False,False,False,False,False,False,False,False,False,False,False,False,False,False,False,False,False,False,False,False,False,False,False,False,False,False,False,False,False,False,False,False,False,False,79.0,70.0,65.0,74.0,32.0,62.0,69,70,63,66,62,75,57,55,52,74,77,80,79,71,68,74,47,70,66,69,46,25,72,72,61,68.0,42,21,21,14,7,10,14,15,,71,71,71,73-2,72-1,72-1,72-1,73-2,71,71,71,71,64+2,64+2,64+2,71,54+2,50+2,50+2,50+2,54+2,51+2,44+2,44+2,44+2,51+2,19+2,ST,237833,CF|ST,67,72,1600000.0,11000.0,23,182,75,14.0,Right,4,2,1,High/High,Normal (170-185),False,False,False,False,False,False,False,False,False,False,False,False,False,False,False,False,False,False,False,False,False,False,False,False,False,False,False,False,False,False,False,False,False,False,False,False,False,False,False,False,False,False,False,False,83.0,63.0,60.0,69.0,40.0,68.0,55,67,61,64,60,68,49,45,57,67,84,82,79,69,73,61,75,74,69,56,54,24,69,65,52,65.0,40,42,48,8,9,13,8,12,,67+2,67+2,67+2,68,68,68,68,68,67+2,67+2,67+2,68+2,62+2,62+2,62+2,68+2,57+2,53+2,53+2,53+2,57+2,55+2,51+2,51+2,51+2,55+2,16+2,ST
39,88.0,2022.0,3-5-2,to_be_implemented,163600,GK,70,70,180000.0,9000.0,35,193,97,14.0,Right,3,1,2,Medium/Medium,Stocky (185+),False,False,False,False,False,False,False,False,False,False,False,False,False,False,False,False,False,False,False,False,False,False,False,False,False,False,False,False,False,False,False,False,False,False,False,False,False,False,False,False,False,False,False,False,,,,,,,14,7,12,25,11,11,13,13,23,23,38,43,23,70,22,54,68,36,71,15,24,22,15,39,18,53.0,11,11,11,70,66,72,70,71,40.0,28+2,28+2,28+2,24,27,27,27,24,26+2,26+2,26+2,26+2,27+2,27+2,27+2,26+2,25+2,27+2,27+2,27+2,25+2,25+2,26+2,26+2,26+2,25+2,69+1,GK,228829,RCB|CB,70,70,1100000.0,17000.0,31,193,81,14.0,Right,2,2,1,Low/Medium,Normal (185+),False,False,False,False,False,False,False,False,False,False,False,False,False,False,False,False,False,False,False,False,False,False,False,False,False,False,False,False,False,False,False,False,False,False,False,False,False,False,False,False,False,False,False,False,52.0,24.0,41.0,44.0,71.0,73.0,23,21,74,52,23,33,24,29,58,55,50,54,41,69,51,33,83,64,80,20,65,73,25,32,34,52.0,71,69,67,7,12,16,16,14,,43+2,43+2,43+2,40,41,41,41,40,42+2,42+2,42+2,43+2,50+2,50+2,50+2,43+2,57+2,63+2,63+2,63+2,57+2,61+2,70,70,70,61+2,19+2,CB,235755,CB,70,76,2300000.0,29000.0,23,191,85,14.0,Left,3,2,1,Low/High,Lean (185+),False,False,False,False,False,False,False,False,False,False,False,False,False,False,False,False,False,False,False,False,False,False,False,False,False,False,False,False,False,False,False,False,False,False,False,False,False,False,False,False,False,False,False,False,78.0,40.0,49.0,59.0,69.0,80.0,36,29,65,65,32,59,46,29,63,60,76,79,57,69,50,54,82,78,84,49,70,69,34,29,52,62.0,70,70,67,13,14,11,10,12,,54+2,54+2,54+2,53,53,53,53,53,53+2,53+2,53+2,56+2,57+2,57+2,57+2,56+2,65+2,67+2,67+2,67+2,65+2,67+2,70+2,70+2,70+2,67+2,18+2,CB,188168,LCB|CB,67,67,325000.0,11000.0,34,188,83,14.0,Left,3,3,1,Medium/Medium,Normal (185+),False,False,False,False,False,False,False,False,False,False,False,False,False,False,False,False,False,False,False,False,False,False,False,False,False,False,False,False,False,False,False,False,False,False,False,False,False,False,False,False,False,False,False,False,50.0,55.0,60.0,63.0,67.0,66.0,61,53,66,64,33,64,66,53,60,63,51,49,64,65,55,62,67,58,72,57,60,67,62,52,49,57.0,66,69,69,11,13,15,6,12,,60+2,60+2,60+2,60,60,60,60,60,60+2,60+2,60+2,60+2,61+2,61+2,61+2,60+2,63+2,64+2,64+2,64+2,63+2,63+2,67,67,67,63+2,17+2,CB,201136,RM|RWB|RB,71,71,1600000.0,20000.0,30,180,76,14.0,Right,4,3,1,Medium/Medium,Normal (170-185),False,False,False,False,False,False,False,False,False,False,False,False,False,False,False,False,False,False,False,False,False,False,False,False,False,False,False,False,False,False,False,False,False,False,False,False,False,False,False,False,False,False,False,False,72.0,34.0,63.0,67.0,69.0,73.0,70,23,63,64,35,66,70,39,66,68,71,72,69,67,68,60,90,74,71,26,71,69,59,56,41,65.0,69,71,70,15,10,9,11,11,,56+2,56+2,56+2,60,58,58,58,60,59+2,59+2,59+2,64+2,63+2,63+2,63+2,64+2,69+2,68+2,68+2,68+2,69+2,69+2,69+2,69+2,69+2,69+2,18+2,RWB,224763,CDM|CM,71,75,2400000.0,5000.0,24,194,78,14.0,Right,3,3,1,Medium/High,Normal (185+),False,False,False,False,False,False,False,False,False,False,False,False,False,False,False,False,False,False,False,False,False,False,False,False,False,False,False,False,False,False,False,False,False,False,False,False,False,False,False,False,False,False,False,False,59.0,45.0,63.0,67.0,70.0,73.0,49,33,70,70,46,69,48,45,71,67,54,63,65,67,48,62,65,62,79,52,73,72,59,68,42,74.0,69,70,67,15,7,12,8,8,,59+2,59+2,59+2,60,61,61,61,60,63+2,63+2,63+2,62+2,67+2,67+2,67+2,62+2,65+2,70+2,70+2,70+2,65+2,65+2,70+2,70+2,70+2,65+2,16+2,CDM,226677,CDM|CM,70,75,2400000.0,16000.0,24,178,74,14.0,Right,3,4,1,Medium/Medium,Lean (170-185),False,False,False,False,False,False,False,False,False,False,False,False,False,False,False,False,False,False,False,False,False,False,False,False,False,False,False,False,False,False,False,False,False,False,False,False,False,False,False,False,False,False,False,False,70.0,69.0,70.0,73.0,65.0,76.0,71,65,61,71,61,74,68,64,72,74,72,68,71,66,68,80,75,73,74,71,84,64,68,70,59,67.0,68,66,56,6,11,8,14,10,,69+2,69+2,69+2,71,70,70,70,71,71+2,71+2,71+2,71+2,70+2,70+2,70+2,71+2,68+2,69+2,69+2,69+2,68+2,67+2,67+2,67+2,67+2,67+2,16+2,CM,192320,CDM|CM,68,68,1200000.0,14000.0,30,186,82,14.0,Right,3,3,1,Medium/Medium,Normal (185+),False,False,False,False,False,False,False,False,False,False,False,False,False,False,False,False,False,False,False,False,False,False,False,False,False,False,False,False,False,False,False,False,False,False,False,False,False,False,False,False,False,False,False,False,52.0,66.0,68.0,65.0,66.0,74.0,70,60,70,69,70,63,70,71,70,69,52,52,60,68,53,75,77,78,73,69,72,66,62,63,70,73.0,62,70,65,11,12,12,9,15,,65+2,65+2,65+2,64,64,64,64,64,65+2,65+2,65+2,65+2,68,68,68,65+2,67+1,69-1,69-1,69-1,67+1,66+2,68,68,68,66+2,18+2,CM,233510,LM|LWB|LB,70,78,3600000.0,16000.0,22,185,75,14.0,Left,3,4,1,High/High,Lean (185+),False,False,False,False,False,False,False,False,False,False,False,False,False,False,False,False,False,False,False,False,False,False,False,False,False,False,False,False,False,False,False,False,False,False,False,False,False,False,False,False,False,False,False,False,80.0,64.0,68.0,69.0,45.0,62.0,69,62,46,67,59,72,68,62,67,70,78,81,74,56,56,73,55,65,59,62,65,42,67,69,51,58.0,43,48,43,13,7,14,8,11,,65+2,65+2,65+2,69,68,68,68,69,68+2,68+2,68+2,69+2,65+2,65+2,65+2,69+2,59+2,57+2,57+2,57+2,59+2,57+2,51+2,51+2,51+2,57+2,15+2,LM,183125,CF|ST,70,70,775000.0,20000.0,34,183,90,14.0,Right,3,2,2,High/Medium,Stocky (170-185),False,False,False,False,False,False,False,False,False,False,False,False,False,False,False,False,False,False,False,False,False,False,False,False,False,False,False,False,False,False,False,False,False,False,False,False,False,False,False,False,False,False,False,False,46.0,71.0,64.0,65.0,37.0,76.0,56,66,79,65,74,62,68,53,61,69,44,48,57,77,65,80,83,43,89,67,83,31,73,74,82,76.0,38,30,25,10,11,16,12,15,,70,70,70,64,67,67,67,64,66+2,66+2,66+2,63+2,63+2,63+2,63+2,63+2,48+2,53+2,53+2,53+2,48+2,46+2,53+2,53+2,53+2,46+2,19+2,ST,215374,CF|ST,69,69,1400000.0,17000.0,30,180,64,14.0,Right,3,3,1,High/Low,Normal (170-185),False,False,False,False,False,False,False,False,False,False,False,False,False,False,False,False,False,False,False,False,False,False,False,False,False,False,False,False,False,False,False,False,False,False,False,False,False,False,False,False,False,False,False,False,80.0,65.0,52.0,68.0,30.0,60.0,48,71,68,55,63,68,60,30,53,66,81,79,71,71,67,68,52,65,64,46,44,27,72,55,65,70.0,23,30,23,9,6,12,8,12,,69,69,69,66,67,67,67,66,64+2,64+2,64+2,65+2,57+2,57+2,57+2,65+2,49+2,46+2,46+2,46+2,49+2,48+2,42+2,42+2,42+2,48+2,16+2,ST
40,1797.0,2022.0,3-5-2,to_be_implemented,224130,GK,66,69,850000.0,4000.0,26,193,72,14.0,Right,3,1,1,Medium/Medium,Normal (185+),False,False,False,False,False,False,False,False,False,False,False,False,False,False,False,False,False,False,False,False,False,False,False,False,False,False,False,False,False,False,False,False,False,False,False,False,False,False,False,False,False,False,False,False,,,,,,,14,18,21,41,13,13,12,15,32,21,40,45,36,61,62,48,58,32,52,12,25,22,12,36,25,39.0,24,20,12,66,65,64,64,66,42.0,29+2,29+2,29+2,26,28,28,28,26,29+2,29+2,29+2,28+2,30+2,30+2,30+2,28+2,28+2,30+2,30+2,30+2,28+2,27+2,28+2,28+2,28+2,27+2,65+2,GK,169575,RCB|CB,68,68,325000.0,5000.0,35,177,73,14.0,Right,2,2,1,Low/High,Normal (170-185),False,False,False,False,False,False,False,False,False,False,False,False,False,False,False,False,False,False,False,False,False,False,False,False,False,False,False,False,False,False,False,False,False,False,False,False,False,False,False,False,False,False,False,False,52.0,38.0,58.0,61.0,69.0,66.0,61,40,61,61,28,60,49,38,59,63,56,49,53,65,70,32,77,53,66,39,80,68,56,57,38,63.0,71,71,71,6,7,13,10,15,,52+2,52+2,52+2,56,55,55,55,56,57+2,57+2,57+2,58+2,60+2,60+2,60+2,58+2,63+2,65+2,65+2,65+2,63+2,64+2,68,68,68,64+2,16+2,CB,223963,CB,68,76,2500000.0,6000.0,23,185,82,14.0,Right,2,2,1,Low/Medium,Normal (185+),False,False,False,False,False,False,False,False,False,False,False,False,False,False,False,False,False,False,False,False,False,False,False,False,False,False,False,False,False,False,False,False,False,False,False,False,False,False,False,False,False,False,False,False,64.0,32.0,48.0,54.0,68.0,72.0,48,24,69,57,26,45,33,35,51,58,60,67,64,69,65,44,81,65,78,33,64,68,47,39,40,58.0,65,71,68,7,14,16,12,6,,50+2,50+2,50+2,50,49,49,49,50,50+2,50+2,50+2,52+2,54+2,54+2,54+2,52+2,62+2,63+2,63+2,63+2,62+2,64+2,68+2,68+2,68+2,64+2,17+2,CB,228225,LCB|CB,68,71,1400000.0,7000.0,25,181,79,14.0,Right,4,2,1,Medium/Medium,Normal (170-185),False,False,False,False,False,False,False,False,False,False,False,False,False,False,False,False,False,False,False,False,False,False,False,False,False,False,False,False,False,False,False,False,False,False,False,False,False,False,False,False,False,False,False,False,75.0,40.0,54.0,60.0,66.0,78.0,58,33,64,63,28,59,34,41,56,63,72,78,54,65,57,55,89,83,79,41,65,66,39,40,42,55.0,66,67,65,12,13,11,15,10,,54+2,54+2,54+2,56,54,54,54,56,54+2,54+2,54+2,59+2,58+2,58+2,58+2,59+2,67+2,65+2,65+2,65+2,67+2,67+2,68+2,68+2,68+2,67+2,18+2,CB,231005,RM|RWB|RB,69,74,1900000.0,8000.0,25,181,75,14.0,Right,4,3,1,High/Low,Lean (170-185),False,False,False,False,False,False,False,False,False,False,False,False,False,False,False,False,False,False,False,False,False,False,False,False,False,False,False,False,False,False,False,False,False,False,False,False,False,False,False,False,False,False,False,False,91.0,58.0,62.0,70.0,56.0,73.0,64,60,52,64,55,72,56,57,55,68,92,91,77,66,65,58,69,82,72,56,65,56,64,63,50,61.0,57,57,57,11,5,11,12,14,,65+2,65+2,65+2,69,67,67,67,69,67+2,67+2,67+2,70+2,64+2,64+2,64+2,70+2,67+2,62+2,62+2,62+2,67+2,65+2,61+2,61+2,61+2,65+2,17+2,RWB,227806,CDM|CM,71,75,2400000.0,10000.0,25,184,62,14.0,Right,3,3,1,Medium/Medium,Lean (170-185),False,False,False,False,False,False,False,False,False,False,False,False,False,False,False,False,False,False,False,False,False,False,False,False,False,False,False,False,False,False,False,False,False,False,False,False,False,False,False,False,False,False,False,False,51.0,61.0,71.0,67.0,66.0,70.0,69,56,53,71,65,66,68,67,73,71,52,51,63,70,65,68,60,77,72,62,60,71,61,71,69,62.0,66,67,63,11,7,10,7,11,,62+2,62+2,62+2,64,64,64,64,64,66+2,66+2,66+2,66+2,70+2,70+2,70+2,66+2,68+2,70+2,70+2,70+2,68+2,66+2,66+2,66+2,66+2,66+2,16+2,CDM,235496,CDM|CM,68,72,1700000.0,7000.0,25,176,76,14.0,Right,3,3,1,High/High,Normal (170-185),False,False,False,False,False,False,False,False,False,False,False,False,False,False,False,False,False,False,False,False,False,False,False,False,False,False,False,False,False,False,False,False,False,False,False,False,False,False,False,False,False,False,False,False,82.0,60.0,63.0,70.0,64.0,77.0,54,56,44,69,52,68,50,51,68,68,81,82,82,66,85,64,69,92,66,67,86,64,62,66,48,65.0,65,68,65,6,6,5,11,15,,63+2,63+2,63+2,67,66,66,66,67,68+2,68+2,68+2,68+2,68+2,68+2,68+2,68+2,69+2,69+2,69+2,69+2,69+2,68+2,66+2,66+2,66+2,68+2,15+2,CM,239023,CDM|CM,67,72,1500000.0,6000.0,23,172,66,14.0,Right,3,3,1,High/Medium,Normal (170-185),False,False,False,False,False,False,False,False,False,False,False,False,False,False,False,False,False,False,False,False,False,False,False,False,False,False,False,False,False,False,False,False,False,False,False,False,False,False,False,False,False,False,False,False,69.0,61.0,65.0,68.0,61.0,72.0,60,62,54,68,41,65,55,56,67,66,72,67,81,65,84,60,79,86,68,64,64,62,63,66,61,62.0,61,64,59,10,7,9,11,13,,63+2,63+2,63+2,66,65,65,65,66,66+2,66+2,66+2,66+2,67+2,67+2,67+2,66+2,66+2,66+2,66+2,66+2,66+2,65+2,63+2,63+2,63+2,65+2,16+2,CM,192624,LM|LWB|LB,67,67,875000.0,6000.0,30,175,66,14.0,Left,3,3,1,Medium/Medium,Lean (170-185),False,False,False,False,False,False,False,False,False,False,False,False,False,False,False,False,False,False,False,False,False,False,False,False,False,False,False,False,False,False,False,False,False,False,False,False,False,False,False,False,False,False,False,False,71.0,56.0,63.0,65.0,61.0,68.0,69,57,59,61,57,63,70,61,60,64,68,74,79,62,77,55,68,80,64,52,61,59,58,63,55,57.0,62,63,62,7,6,7,9,9,,60+2,60+2,60+2,63,61,61,61,63,62+2,62+2,62+2,64+2,62+2,62+2,62+2,64+2,65+2,63+2,63+2,63+2,65+2,65+2,62+2,62+2,62+2,65+2,14+2,LWB,198011,CF|ST,66,66,850000.0,6000.0,30,191,93,14.0,Right,4,2,1,High/High,Normal (185+),False,False,False,False,False,False,False,False,False,False,False,False,False,False,False,False,False,False,False,False,False,False,False,False,False,False,False,False,False,False,False,False,False,False,False,False,False,False,False,False,False,False,False,False,53.0,66.0,47.0,60.0,37.0,80.0,33,65,73,55,63,60,40,38,41,64,52,54,58,63,34,74,69,69,91,60,67,24,66,53,65,61.0,31,42,31,14,14,9,6,6,,66,66,66,58,61,61,61,58,59+2,59+2,59+2,56+2,55+2,55+2,55+2,56+2,46+2,49+2,49+2,49+2,46+2,45+2,50+2,50+2,50+2,45+2,16+2,ST,217758,CF|ST,65,65,700000.0,5000.0,30,178,85,14.0,Right,3,2,1,High/Medium,Stocky (170-185),False,False,False,False,False,False,False,False,False,False,False,False,False,False,False,False,False,False,False,False,False,False,False,False,False,False,False,False,False,False,False,False,False,False,False,False,False,False,False,False,False,False,False,False,75.0,65.0,57.0,65.0,34.0,72.0,57,65,60,59,58,63,45,43,55,64,76,74,73,64,67,66,72,71,71,67,75,30,65,62,68,65.0,36,28,27,12,10,7,8,14,,65,65,65,65,65,65,65,65,64+1,64+1,64+1,64+1,59+2,59+2,59+2,64+1,51+2,50+2,50+2,50+2,51+2,49+2,47+2,47+2,47+2,49+2,17+2,ST
41,1917.0,2022.0,3-5-2,to_be_implemented,173531,GK,68,68,600000.0,4000.0,32,193,76,14.0,Right,3,1,1,Medium/Medium,Normal (185+),False,False,False,False,False,False,False,False,False,False,False,False,False,False,False,False,False,False,False,False,False,False,False,False,False,False,False,False,False,False,False,False,False,False,False,False,False,False,False,False,False,False,False,False,,,,,,,14,13,15,43,13,14,13,11,48,23,50,45,54,64,52,53,57,28,62,15,28,23,14,63,11,61.0,17,11,12,69,67,71,65,67,48.0,30+2,30+2,30+2,30,32,32,32,30,35+2,35+2,35+2,32+2,36+2,36+2,36+2,32+2,27+2,32+2,32+2,32+2,27+2,27+2,27+2,27+2,27+2,27+2,67+1,GK,211166,RCB|CB,69,73,1700000.0,5000.0,25,190,82,14.0,Right,4,2,1,Low/High,Normal (185+),False,False,False,False,False,False,False,False,False,False,False,False,False,False,False,False,False,False,False,False,False,False,False,False,False,False,False,False,False,False,False,False,False,False,False,False,False,False,False,False,False,False,False,False,64.0,26.0,48.0,56.0,68.0,80.0,27,24,67,63,24,51,26,27,65,60,56,71,61,69,44,34,84,83,83,26,66,66,22,42,25,67.0,68,69,66,15,9,15,16,8,,47+2,47+2,47+2,47,47,47,47,47,50+2,50+2,50+2,52+2,57+2,57+2,57+2,52+2,62+2,66+2,66+2,66+2,62+2,64+2,69+2,69+2,69+2,64+2,18+2,CB,225589,CB,69,73,1700000.0,5000.0,25,190,75,14.0,Right,3,2,1,High/Medium,Normal (185+),False,False,False,False,False,False,False,False,False,False,False,False,False,False,False,False,False,False,False,False,False,False,False,False,False,False,False,False,False,False,False,False,False,False,False,False,False,False,False,False,False,False,False,False,68.0,49.0,53.0,59.0,66.0,81.0,39,49,69,63,36,56,39,40,62,60,69,68,61,62,64,61,92,78,84,37,75,65,55,48,60,66.0,67,65,64,13,15,14,11,12,,59+2,59+2,59+2,56,57,57,57,56,57+2,57+2,57+2,58+2,59+2,59+2,59+2,58+2,62+2,65+2,65+2,65+2,62+2,64+2,69+2,69+2,69+2,64+2,18+2,CB,234039,LCB|CB,68,73,1600000.0,7000.0,23,181,73,14.0,Right,2,2,1,High/Medium,Stocky (170-185),False,False,False,False,False,False,False,False,False,False,False,False,False,False,False,False,False,False,False,False,False,False,False,False,False,False,False,False,False,False,False,False,False,False,False,False,False,False,False,False,False,False,False,False,72.0,31.0,56.0,61.0,68.0,69.0,54,25,65,63,32,61,51,42,54,59,71,73,64,66,64,40,88,59,74,27,64,70,49,50,40,63.0,68,67,66,14,8,11,12,14,,52+2,52+2,52+2,55,54,54,54,55,55+2,55+2,55+2,58+2,57+2,57+2,57+2,58+2,64+2,64+2,64+2,64+2,64+2,65+2,68+2,68+2,68+2,65+2,18+2,CB,228684,RM|RWB|RB,71,75,2500000.0,7000.0,24,178,70,14.0,Right,3,3,1,Medium/High,Normal (170-185),False,False,False,False,False,False,False,False,False,False,False,False,False,False,False,False,False,False,False,False,False,False,False,False,False,False,False,False,False,False,False,False,False,False,False,False,False,False,False,False,False,False,False,False,81.0,33.0,58.0,69.0,68.0,76.0,67,32,63,66,30,71,46,38,59,66,81,81,73,64,70,34,76,77,83,30,58,65,52,43,36,58.0,70,70,68,8,16,14,11,10,,55+2,55+2,55+2,61,58,58,58,61,59+2,59+2,59+2,64+2,60+2,60+2,60+2,64+2,69+2,66+2,66+2,66+2,69+2,69+2,69+2,69+2,69+2,69+2,17+2,RWB,200302,CDM|CM,69,69,1200000.0,6000.0,30,175,72,14.0,Left,2,3,1,Medium/High,Lean (170-185),False,False,False,False,False,False,False,False,False,False,False,False,False,False,False,False,False,False,False,False,False,False,False,False,False,False,False,False,False,False,False,False,False,False,False,False,False,False,False,False,False,False,False,False,61.0,55.0,66.0,66.0,67.0,73.0,68,46,50,68,52,64,67,68,65,65,63,60,69,67,76,69,81,80,66,56,81,67,58,62,70,67.0,70,68,67,13,6,6,14,12,,59+2,59+2,59+2,62,61,61,61,62,63+2,63+2,63+2,64+2,65+2,65+2,65+2,64+2,68+1,68+1,68+1,68+1,68+1,67+2,67+2,67+2,67+2,67+2,17+2,CDM,206536,CDM|CM,69,69,975000.0,6000.0,31,188,72,14.0,Right,3,2,1,Medium/High,Lean (185+),False,False,False,False,False,False,False,False,False,False,False,False,False,False,False,False,False,False,False,False,False,False,False,False,False,False,False,False,False,False,False,False,False,False,False,False,False,False,False,False,False,False,False,False,64.0,61.0,63.0,62.0,67.0,81.0,56,56,66,67,51,60,55,52,66,62,64,64,66,64,63,72,73,90,80,68,75,67,55,64,52,63.0,67,67,66,8,13,9,10,8,,63+2,63+2,63+2,61,62,62,62,61,63+2,63+2,63+2,63+2,66+2,66+2,66+2,63+2,67+2,68+1,68+1,68+1,67+2,67+2,68+1,68+1,68+1,67+2,16+2,CDM,200667,CDM|CM,68,68,1200000.0,5000.0,28,181,78,14.0,Right,3,3,1,Medium/Medium,Normal (170-185),False,False,False,False,False,False,False,False,False,False,False,False,False,False,False,False,False,False,False,False,False,False,False,False,False,False,False,False,False,False,False,False,False,False,False,False,False,False,False,False,False,False,False,False,56.0,65.0,68.0,66.0,65.0,80.0,70,63,68,67,56,65,63,66,68,66,58,55,62,67,75,72,76,93,76,66,74,64,64,67,59,65.0,65,64,63,7,14,14,11,7,,65+2,65+2,65+2,65,65,65,65,65,65+2,65+2,65+2,66+2,68,68,68,66+2,68,68,68,68,68,67+1,67+1,67+1,67+1,67+1,16+2,CM,198489,LM|LWB|LB,69,69,875000.0,6000.0,33,180,70,14.0,Left,2,3,1,High/Medium,Normal (170-185),False,False,False,False,False,False,False,False,False,False,False,False,False,False,False,False,False,False,False,False,False,False,False,False,False,False,False,False,False,False,False,False,False,False,False,False,False,False,False,False,False,False,False,False,69.0,64.0,65.0,71.0,62.0,77.0,70,63,62,65,59,70,67,61,62,71,70,69,75,69,73,70,68,80,71,62,88,56,67,64,65,66.0,65,61,63,6,16,16,15,15,,67+2,67+2,67+2,68,67,67,67,68,67+2,67+2,67+2,68+1,66+2,66+2,66+2,68+1,67+2,66+2,66+2,66+2,67+2,66+2,65+2,65+2,65+2,66+2,19+2,LM,213699,CF|ST,69,72,1800000.0,21000.0,26,188,78,14.0,Right,2,3,1,Medium/Low,Normal (185+),False,False,False,False,False,False,False,False,False,False,False,False,False,False,False,False,False,False,False,False,False,False,False,False,False,False,False,False,False,False,False,False,False,False,False,False,False,False,False,False,False,False,False,False,73.0,68.0,45.0,66.0,29.0,69.0,23,69,72,59,53,67,44,41,38,65,67,77,75,67,56,75,71,63,73,66,65,22,67,49,52,62.0,17,32,23,14,8,12,8,8,,69+2,69+2,69+2,62,66,66,66,62,62+2,62+2,62+2,59+2,55+2,55+2,55+2,59+2,44+2,45+2,45+2,45+2,44+2,44+2,45+2,45+2,45+2,44+2,16+2,ST,204217,CF|ST,68,68,1200000.0,6000.0,29,188,80,14.0,Right,3,2,1,High/Medium,Stocky (185+),False,False,False,False,False,False,False,False,False,False,False,False,False,False,False,False,False,False,False,False,False,False,False,False,False,False,False,False,False,False,False,False,False,False,False,False,False,False,False,False,False,False,False,False,55.0,69.0,57.0,63.0,37.0,76.0,46,70,72,63,65,62,57,52,54,67,54,56,59,66,51,71,85,66,83,64,70,31,70,61,65,65.0,39,32,27,16,12,15,10,12,,68,68,68,62,65,65,65,62,64+2,64+2,64+2,61+2,60+2,60+2,60+2,61+2,49+2,52+2,52+2,52+2,49+2,47+2,51+2,51+2,51+2,47+2,19+2,ST
42,1926.0,2022.0,3-5-2,to_be_implemented,209333,GK,68,68,650000.0,5000.0,31,185,74,14.0,Right,3,1,1,Medium/Medium,Normal (185+),False,False,False,False,False,False,False,False,False,False,False,False,False,False,False,False,False,False,False,False,False,False,False,False,False,False,False,False,False,False,False,False,False,False,False,False,False,False,False,False,False,False,False,False,,,,,,,18,11,15,23,17,13,16,13,16,26,39,45,45,64,50,51,62,30,60,16,25,25,14,35,20,35.0,14,12,12,69,66,68,70,66,41.0,28+2,28+2,28+2,26,27,27,27,26,26+2,26+2,26+2,26+2,26+2,26+2,26+2,26+2,26+2,26+2,26+2,26+2,26+2,25+2,26+2,26+2,26+2,25+2,67+1,GK,250810,RCB|CB,71,74,2200000.0,9000.0,26,193,84,14.0,Right,1,2,1,Medium/Medium,Lean (185+),False,False,False,False,False,False,False,False,False,False,False,False,False,False,False,False,False,False,False,False,False,False,False,False,False,False,False,False,False,False,False,False,False,False,False,False,False,False,False,False,False,False,False,False,69.0,29.0,48.0,52.0,71.0,76.0,39,25,69,59,28,49,35,31,52,56,68,70,44,67,49,40,67,68,85,23,68,69,36,44,36,68.0,73,72,71,7,10,8,7,6,,49+2,49+2,49+2,49,49,49,49,49,49+2,49+2,49+2,52+2,54+2,54+2,54+2,52+2,63+2,65+2,65+2,65+2,63+2,65+2,71+2,71+2,71+2,65+2,14+2,CB,205596,CB,67,67,875000.0,5000.0,28,179,65,14.0,Left,3,2,1,Medium/Medium,Normal (170-185),False,False,False,False,False,False,False,False,False,False,False,False,False,False,False,False,False,False,False,False,False,False,False,False,False,False,False,False,False,False,False,False,False,False,False,False,False,False,False,False,False,False,False,False,65.0,49.0,58.0,64.0,67.0,71.0,64,46,61,58,41,64,67,50,51,65,63,66,61,61,66,60,73,72,69,45,74,66,56,57,47,58.0,68,68,67,8,10,14,14,15,,58+2,58+2,58+2,60,59,59,59,60,58+2,58+2,58+2,61+2,59+2,59+2,59+2,61+2,65+2,64+2,64+2,64+2,65+2,65+2,67,67,67,65+2,17+2,CB,229349,LCB|CB,66,72,1200000.0,4000.0,25,181,79,14.0,Left,2,2,1,Medium/High,Normal (170-185),False,False,False,False,False,False,False,False,False,False,False,False,False,False,False,False,False,False,False,False,False,False,False,False,False,False,False,False,False,False,False,False,False,False,False,False,False,False,False,False,False,False,False,False,62.0,36.0,50.0,55.0,66.0,71.0,50,32,64,61,34,52,32,29,56,56,65,60,52,62,70,43,78,64,74,34,68,65,31,36,49,66.0,66,67,65,14,12,12,7,7,,49+2,49+2,49+2,50,48,48,48,50,49+2,49+2,49+2,52+2,53+2,53+2,53+2,52+2,61+2,62+2,62+2,62+2,61+2,62+2,66+2,66+2,66+2,62+2,16+2,CB,232106,RM|RWB|RB,68,74,1800000.0,5000.0,23,178,75,14.0,Right,2,2,1,High/Medium,Normal (170-185),False,False,False,False,False,False,False,False,False,False,False,False,False,False,False,False,False,False,False,False,False,False,False,False,False,False,False,False,False,False,False,False,False,False,False,False,False,False,False,False,False,False,False,False,83.0,34.0,52.0,64.0,63.0,67.0,61,29,53,56,36,66,46,37,50,60,81,84,74,62,70,36,80,76,65,33,58,63,57,45,44,53.0,60,67,68,12,14,7,12,13,,52+2,52+2,52+2,59,55,55,55,59,56+2,56+2,56+2,61+2,56+2,56+2,56+2,61+2,66+2,61+2,61+2,61+2,66+2,66+2,63+2,63+2,63+2,66+2,18+2,RB,233105,CDM|CM,70,70,1400000.0,8000.0,29,182,79,14.0,Right,4,3,1,Medium/High,Normal (170-185),False,False,False,False,False,False,False,False,False,False,False,False,False,False,False,False,False,False,False,False,False,False,False,False,False,False,False,False,False,False,False,False,False,False,False,False,False,False,False,False,False,False,False,False,70.0,51.0,63.0,66.0,68.0,73.0,56,45,63,70,37,66,46,51,66,65,72,69,70,68,69,59,76,77,71,55,74,68,59,63,53,61.0,65,71,69,15,9,10,10,9,,60+2,60+2,60+2,63,63,63,63,63,64+2,64+2,64+2,65+2,66+2,66+2,66+2,65+2,68+2,69+1,69+1,69+1,68+2,68+2,69+1,69+1,69+1,68+2,17+2,CDM,206538,CDM|CM,69,69,1200000.0,7000.0,28,181,73,14.0,Right,3,3,1,Medium/High,Lean (170-185),False,False,False,False,False,False,False,False,False,False,False,False,False,False,False,False,False,False,False,False,False,False,False,False,False,False,False,False,False,False,False,False,False,False,False,False,False,False,False,False,False,False,False,False,64.0,53.0,61.0,66.0,68.0,70.0,55,51,63,69,25,66,41,30,66,66,67,62,68,65,65,64,68,68,70,54,72,67,52,62,44,66.0,67,71,69,13,7,8,10,13,,60+2,60+2,60+2,62,62,62,62,62,63+2,63+2,63+2,63+2,65+2,65+2,65+2,63+2,66+2,68+1,68+1,68+1,66+2,66+2,68+1,68+1,68+1,66+2,17+2,CDM,242423,CDM|CM,66,75,1900000.0,4000.0,22,182,72,14.0,Right,3,3,1,Medium/Medium,Lean (170-185),False,False,False,False,False,False,False,False,False,False,False,False,False,False,False,False,False,False,False,False,False,False,False,False,False,False,False,False,False,False,False,False,False,False,False,False,False,False,False,False,False,False,False,False,67.0,61.0,64.0,67.0,57.0,66.0,57,61,51,67,60,65,60,58,65,68,68,66,74,66,69,65,62,77,65,60,58,59,64,65,56,64.0,57,58,54,6,7,14,11,7,,63+2,63+2,63+2,65,65,65,65,65,66+2,66+2,66+2,65+2,66+2,66+2,66+2,65+2,63+2,63+2,63+2,63+2,63+2,62+2,59+2,59+2,59+2,62+2,14+2,CM,227686,LM|LWB|LB,69,69,1500000.0,7000.0,27,175,71,14.0,Right,3,3,1,High/Medium,Normal (170-185),False,False,False,False,False,False,False,False,False,False,False,False,False,False,False,False,False,False,False,False,False,False,False,False,False,False,False,False,False,False,False,False,False,False,False,False,False,False,False,False,False,False,False,False,83.0,63.0,62.0,71.0,54.0,59.0,56,64,59,67,57,72,54,54,60,67,84,83,85,65,81,64,61,77,57,60,43,46,67,65,61,60.0,54,59,47,7,8,12,6,8,,66+2,66+2,66+2,69,68,68,68,69,68+1,68+1,68+1,68+1,65+2,65+2,65+2,68+1,62+2,59+2,59+2,59+2,62+2,61+2,56+2,56+2,56+2,61+2,14+2,LM,226507,CF|ST,68,72,1700000.0,6000.0,25,183,80,14.0,Right,3,3,1,High/High,Normal (170-185),False,False,False,False,False,False,False,False,False,False,False,False,False,False,False,False,False,False,False,False,False,False,False,False,False,False,False,False,False,False,False,False,False,False,False,False,False,False,False,False,False,False,False,False,78.0,68.0,56.0,69.0,29.0,68.0,45,70,63,62,63,68,57,46,43,68,76,79,74,67,80,68,84,81,65,65,54,24,70,66,71,64.0,25,27,22,6,8,10,10,11,,68+2,68+2,68+2,67,68,68,68,67,67+2,67+2,67+2,66+2,60+2,60+2,60+2,66+2,50+2,47+2,47+2,47+2,50+2,48+2,43+2,43+2,43+2,48+2,15+2,ST,238990,CF|ST,67,75,2300000.0,5000.0,23,182,73,14.0,Right,3,2,1,High/Medium,Normal (170-185),False,False,False,False,False,False,False,False,False,False,False,False,False,False,False,False,False,False,False,False,False,False,False,False,False,False,False,False,False,False,False,False,False,False,False,False,False,False,False,False,False,False,False,False,78.0,68.0,50.0,68.0,24.0,62.0,45,71,61,59,63,67,54,40,42,64,79,77,80,68,76,69,66,72,58,63,58,16,68,49,67,59.0,19,19,30,13,12,12,13,8,,67+2,67+2,67+2,65,66,66,66,65,63+2,63+2,63+2,63+2,55+2,55+2,55+2,63+2,48+2,43+2,43+2,43+2,48+2,45+2,39+2,39+2,39+2,45+2,18+2,ST
43,106.0,2022.0,3-5-2,to_be_implemented,225134,GK,64,68,675000.0,3000.0,24,191,70,14.0,Right,3,1,1,Medium/Medium,Lean (185+),False,False,False,False,False,False,False,False,False,False,False,False,False,False,False,False,False,False,False,False,False,False,False,False,False,False,False,False,False,False,False,False,False,False,False,False,False,False,False,False,False,False,False,False,,,,,,,14,16,14,33,14,15,19,16,40,20,61,54,60,60,62,48,74,30,56,20,32,27,13,45,20,42.0,10,21,25,65,62,64,60,66,58.0,29+2,29+2,29+2,29,30,30,30,29,31+2,31+2,31+2,30+2,31+2,31+2,31+2,30+2,29+2,31+2,31+2,31+2,29+2,29+2,29+2,29+2,29+2,29+2,63+2,GK,243908,RCB|CB,70,81,3300000.0,8000.0,22,187,85,14.0,Right,3,2,1,Medium/High,Normal (185+),False,False,False,False,False,False,False,False,False,False,False,False,False,False,False,False,False,False,False,False,False,False,False,False,False,False,False,False,False,False,False,False,False,False,False,False,False,False,False,False,False,False,False,False,52.0,30.0,49.0,50.0,71.0,73.0,31,25,70,60,31,43,28,30,63,59,48,55,44,68,48,44,71,58,80,26,73,70,36,49,37,57.0,70,72,70,13,7,7,8,7,,48+2,48+2,48+2,46,48,48,48,46,49+2,49+2,49+2,49+2,56+2,56+2,56+2,49+2,59+2,66+2,66+2,66+2,59+2,62+2,70+2,70+2,70+2,62+2,15+2,CB,195037,CB,69,69,950000.0,8000.0,31,191,90,14.0,Right,2,2,1,Low/High,Normal (185+),False,False,False,False,False,False,False,False,False,False,False,False,False,False,False,False,False,False,False,False,False,False,False,False,False,False,False,False,False,False,False,False,False,False,False,False,False,False,False,False,False,False,False,False,31.0,23.0,42.0,39.0,69.0,82.0,24,20,72,56,18,31,25,16,53,46,30,31,35,63,33,32,73,69,91,18,76,70,35,39,27,51.0,69,66,68,11,11,8,10,9,,41+2,41+2,41+2,36,39,39,39,36,41+2,41+2,41+2,40+2,49+2,49+2,49+2,40+2,54+2,63+2,63+2,63+2,54+2,57+2,69,69,69,57+2,16+2,CB,198810,LCB|CB,68,68,1000000.0,7000.0,29,184,79,14.0,Right,3,2,1,Medium/High,Normal (170-185),False,False,False,False,False,False,False,False,False,False,False,False,False,False,False,False,False,False,False,False,False,False,False,False,False,False,False,False,False,False,False,False,False,False,False,False,False,False,False,False,False,False,False,False,52.0,38.0,51.0,52.0,67.0,76.0,47,39,68,61,22,44,36,27,54,59,53,52,52,67,57,40,87,69,79,36,72,66,39,46,39,64.0,68,67,66,13,10,15,15,16,,50+2,50+2,50+2,50,50,50,50,50,51+2,51+2,51+2,52+2,55+2,55+2,55+2,52+2,61+2,64+2,64+2,64+2,61+2,62+2,68,68,68,62+2,19+2,CB,254088,RM|RWB|RB,69,85,3600000.0,23000.0,19,173,72,14.0,Left,4,4,1,High/Medium,Lean (170-185),False,False,False,False,False,False,False,False,False,False,False,False,False,False,False,False,False,False,False,False,False,False,False,False,False,False,False,False,False,False,False,False,False,False,False,False,False,False,False,False,False,False,False,False,81.0,63.0,61.0,74.0,25.0,48.0,57,66,48,62,54,74,62,60,61,72,88,76,88,64,85,60,58,57,45,59,40,22,72,63,55,66.0,19,25,22,13,15,8,11,6,,65+2,65+2,65+2,70,69,69,69,70,69+2,69+2,69+2,68+2,61+2,61+2,61+2,68+2,49+2,45+2,45+2,45+2,49+2,46+2,37+2,37+2,37+2,46+2,17+2,RM,215700,CDM|CM,67,69,1100000.0,6000.0,27,174,74,14.0,Right,4,2,1,Medium/High,Lean (170-185),False,False,False,False,False,False,False,False,False,False,False,False,False,False,False,False,False,False,False,False,False,False,False,False,False,False,False,False,False,False,False,False,False,False,False,False,False,False,False,False,False,False,False,False,75.0,58.0,62.0,64.0,62.0,79.0,57,57,58,64,60,61,60,56,63,63,76,75,77,61,81,58,86,90,73,60,78,63,59,63,59,63.0,62,63,60,9,14,8,14,10,,62+2,62+2,62+2,63,62,62,62,63,63+2,63+2,63+2,64+2,64+2,64+2,64+2,64+2,66+2,66+2,66+2,66+2,66+2,65+2,65+2,65+2,65+2,65+2,17+2,CDM,258483,CDM|CM,67,80,2300000.0,4000.0,20,178,65,14.0,Right,4,2,1,Medium/High,Lean (170-185),False,False,False,False,False,False,False,False,False,False,False,False,False,False,False,False,False,False,False,False,False,False,False,False,False,False,False,False,False,False,False,False,False,False,False,False,False,False,False,False,False,False,False,False,74.0,60.0,63.0,67.0,63.0,73.0,53,58,55,68,53,67,53,51,65,68,74,74,72,60,69,60,64,81,72,65,67,64,63,67,57,62.0,65,65,59,8,15,10,9,6,,63+2,63+2,63+2,65,65,65,65,65,66+2,66+2,66+2,66+2,67+2,67+2,67+2,66+2,66+2,66+2,66+2,66+2,66+2,65+2,64+2,64+2,64+2,65+2,15+2,CDM,261249,CDM|CM,66,84,2200000.0,10000.0,19,178,68,14.0,Right,3,3,1,High/Medium,Lean (170-185),False,False,False,False,False,False,False,False,False,False,False,False,False,False,False,False,False,False,False,False,False,False,False,False,False,False,False,False,False,False,False,False,False,False,False,False,False,False,False,False,False,False,False,False,62.0,53.0,65.0,71.0,57.0,51.0,59,50,45,70,48,71,61,48,66,71,65,59,72,65,78,58,40,57,42,55,67,62,61,67,55,70.0,55,61,56,9,13,11,8,9,,58+2,58+2,58+2,64,64,64,64,64,66+2,66+2,66+2,65+2,66+2,66+2,66+2,65+2,62+2,63+2,63+2,63+2,62+2,61+2,57+2,57+2,57+2,61+2,16+2,CM,268709,LM|LWB|LB,68,80,2800000.0,3000.0,18,175,70,14.0,Left,3,3,1,Medium/Medium,Lean (170-185),False,False,False,False,False,False,False,False,False,False,False,False,False,False,False,False,False,False,False,False,False,False,False,False,False,False,False,False,False,False,False,False,False,False,False,False,False,False,False,False,False,False,False,False,79.0,55.0,61.0,70.0,27.0,46.0,63,63,34,65,46,68,43,33,62,72,76,82,80,60,76,56,49,60,45,39,31,24,64,61,49,52.0,25,28,24,14,11,7,12,9,,60+2,60+2,60+2,67,65,65,65,67,65+2,65+2,65+2,67+2,60+2,60+2,60+2,67+2,51+2,46+2,46+2,46+2,51+2,47+2,36+2,36+2,36+2,47+2,17+2,LM,244319,CF|ST,70,73,2100000.0,11000.0,25,193,81,14.0,Right,3,2,1,High/Medium,Lean (185+),False,False,False,False,False,False,False,False,False,False,False,False,False,False,False,False,False,False,False,False,False,False,False,False,False,False,False,False,False,False,False,False,False,False,False,False,False,False,False,False,False,False,False,False,75.0,69.0,57.0,63.0,30.0,76.0,44,73,74,63,60,63,61,51,54,67,77,73,55,67,48,68,55,89,77,64,64,23,71,60,67,61.0,26,24,27,11,13,14,12,7,,70+2,70+2,70+2,65,68,68,68,65,65+2,65+2,65+2,65+2,61+2,61+2,61+2,65+2,51+2,49+2,49+2,49+2,51+2,49+2,45+2,45+2,45+2,49+2,17+2,ST,251198,CF|ST,68,78,2700000.0,12000.0,21,191,73,14.0,Right,4,3,1,Medium/Low,Normal (185+),False,False,False,False,False,False,False,False,False,False,False,False,False,False,False,False,False,False,False,False,False,False,False,False,False,False,False,False,False,False,False,False,False,False,False,False,False,False,False,False,False,False,False,False,74.0,68.0,52.0,65.0,25.0,73.0,45,72,64,58,60,64,55,51,44,65,75,74,68,62,66,68,67,70,79,60,63,21,70,52,64,65.0,19,24,19,13,10,14,11,9,,68+2,68+2,68+2,64,65,65,65,64,62+2,62+2,62+2,62+2,55+2,55+2,55+2,62+2,46+2,44+2,44+2,44+2,46+2,44+2,42+2,42+2,42+2,44+2,17+2,ST
